7pcx1	ATCAGCCTCGACTGTGCCTTCTAGTTGCCAGCCATCAGCCTCGACTGTGCCTTCTAGTTGCCAGCCATCGAGACTATACAACCTACTACCTCAGTCGCAATCAGCCTCGACTGTGCCTTCTAGTTGCCAGCC
6merx1	ATCAGCCTCGACTGTGCCTTCTAGTTGCCAGCCATCAGCCTCGACTGTGCCTTCTAGTTGCCAGCCATCGAGACTATACAAGGATATACCTCCGTCGCAATCAGCCTCGACTGTGCCTTCTAGTTGCCAGCC
7pcx2	ATCGAGACTATACAACCTACTACCTCAGTCGCAATCAGCCTCGACTGTGCCTTCTAGTTGCCAGCCATCGAGACTATACAACCTACTACCTCAGTCGCAATCAGCCTCGACTGTGCCTTCTAGTTGCCAGCC
6merx2	ATCGAGACTATACAAGGATATACCTCCGTCGCAATCAGCCTCGACTGTGCCTTCTAGTTGCCAGCCATCGAGACTATACAAGGATATACCTCCGTCGCAATCAGCCTCGACTGTGCCTTCTAGTTGCCAGCC
7pcx4	ATCGAGACTATACAACCTACTACCTCAGTCGCAATCGAGACTATACAACCTACTACCTCAGTCGCAATCGAGACTATACAACCTACTACCTCAGTCGCAATCGAGACTATACAACCTACTACCTCAGTCGCA
6merx4	ATCGAGACTATACAAGGATATACCTCCGTCGCAATCGAGACTATACAAGGATATACCTCCGTCGCAATCGAGACTATACAAGGATATACCTCCGTCGCAATCGAGACTATACAAGGATATACCTCCGTCGCA
7mera1x4	ATCGAGACTATACAAGGATATACCTCAGTCGCAATCGAGACTATACAAGGATATACCTCAGTCGCAATCGAGACTATACAAGGATATACCTCAGTCGCAATCGAGACTATACAAGGATATACCTCAGTCGCA
7mera1x1	ATCAGCCTCGACTGTGCCTTCTAGTTGCCAGCCATCAGCCTCGACTGTGCCTTCTAGTTGCCAGCCATCGAGACTATACAAGGATATACCTCAGTCGCAATCAGCCTCGACTGTGCCTTCTAGTTGCCAGCC
7merm8x1	ATCAGCCTCGACTGTGCCTTCTAGTTGCCAGCCATCAGCCTCGACTGTGCCTTCTAGTTGCCAGCCATCGAGACTATACAAGGATCTACCTCCGTCGCAATCAGCCTCGACTGTGCCTTCTAGTTGCCAGCC
7merm8x2	ATCGAGACTATACAAGGATCTACCTCCGTCGCAATCAGCCTCGACTGTGCCTTCTAGTTGCCAGCCATCGAGACTATACAAGGATCTACCTCCGTCGCAATCAGCCTCGACTGTGCCTTCTAGTTGCCAGCC
7mera1x2	ATCGAGACTATACAAGGATATACCTCAGTCGCAATCAGCCTCGACTGTGCCTTCTAGTTGCCAGCCATCGAGACTATACAAGGATATACCTCAGTCGCAATCAGCCTCGACTGTGCCTTCTAGTTGCCAGCC
7merm8x4	ATCGAGACTATACAAGGATCTACCTCCGTCGCAATCGAGACTATACAAGGATCTACCTCCGTCGCAATCGAGACTATACAAGGATCTACCTCCGTCGCAATCGAGACTATACAAGGATCTACCTCCGTCGCA
C14orf28	ATCGAAAAAAACATTTTTCTACCTCTGTCGCAAATCGAAAAAAACATTTTTCTACCTCTGTCGCAAATCGAAAAAAACATTTTTCTACCTCTGTCGCAAATCGAAAAAAACATTTTTCTACCTCTGTCGCAA
AAAA	TATTTATTTATTTATTTGTTTGTTTGTTTTATTTATTTATTTATTTATTTGTTTGTTTGTTTTATTTATTTATTTATTTATTTGTTTGTTTGTTTTATTTATTTATTTATTTATTTGTTTGTTTGTTTTATT
AAAB	TATTTATTTATTTATTTGTTTGTTTGTTTTATTTATTTATTTATTTATTTGTTTGTTTGTTTTATTTATTTATTTATTTATTTGTTTGTTTGTTTTATTATCAGCCTCGACTGTGCCTTCTAGTTGCCAGCC
AAAL	TATTTATTTATTTATTTGTTTGTTTGTTTTATTTATTTATTTATTTATTTGTTTGTTTGTTTTATTTATTTATTTATTTATTTGTTTGTTTGTTTTATTATCGAGACTATACAAGGATCTACCTCAGTCGCA
AAAS	TATTTATTTATTTATTTGTTTGTTTGTTTTATTTATTTATTTATTTATTTGTTTGTTTGTTTTATTTATTTATTTATTTATTTGTTTGTTTGTTTTATTCACAAGCAGAGGCTCTGGCAGCTTTTGCCAACA
AAAp	TATTTATTTATTTATTTGTTTGTTTGTTTTATTTATTTATTTATTTATTTGTTTGTTTGTTTTATTTATTTATTTATTTATTTGTTTGTTTGTTTTATTGTCAGCTCCGACTTGTAAATATCAGCCTCGACT
AABA	TATTTATTTATTTATTTGTTTGTTTGTTTTATTTATTTATTTATTTATTTGTTTGTTTGTTTTATTATCAGCCTCGACTGTGCCTTCTAGTTGCCAGCCTATTTATTTATTTATTTGTTTGTTTGTTTTATT
AABB	TATTTATTTATTTATTTGTTTGTTTGTTTTATTTATTTATTTATTTATTTGTTTGTTTGTTTTATTATCAGCCTCGACTGTGCCTTCTAGTTGCCAGCCATCAGCCTCGACTGTGCCTTCTAGTTGCCAGCC
AABL	TATTTATTTATTTATTTGTTTGTTTGTTTTATTTATTTATTTATTTATTTGTTTGTTTGTTTTATTATCAGCCTCGACTGTGCCTTCTAGTTGCCAGCCATCGAGACTATACAAGGATCTACCTCAGTCGCA
AABS	TATTTATTTATTTATTTGTTTGTTTGTTTTATTTATTTATTTATTTATTTGTTTGTTTGTTTTATTATCAGCCTCGACTGTGCCTTCTAGTTGCCAGCCCACAAGCAGAGGCTCTGGCAGCTTTTGCCAACA
AABp	TATTTATTTATTTATTTGTTTGTTTGTTTTATTTATTTATTTATTTATTTGTTTGTTTGTTTTATTATCAGCCTCGACTGTGCCTTCTAGTTGCCAGCCGTCAGCTCCGACTTGTAAATATCAGCCTCGACT
AALA	TATTTATTTATTTATTTGTTTGTTTGTTTTATTTATTTATTTATTTATTTGTTTGTTTGTTTTATTATCGAGACTATACAAGGATCTACCTCAGTCGCATATTTATTTATTTATTTGTTTGTTTGTTTTATT
AALB	TATTTATTTATTTATTTGTTTGTTTGTTTTATTTATTTATTTATTTATTTGTTTGTTTGTTTTATTATCGAGACTATACAAGGATCTACCTCAGTCGCAATCAGCCTCGACTGTGCCTTCTAGTTGCCAGCC
AALL	TATTTATTTATTTATTTGTTTGTTTGTTTTATTTATTTATTTATTTATTTGTTTGTTTGTTTTATTATCGAGACTATACAAGGATCTACCTCAGTCGCAATCGAGACTATACAAGGATCTACCTCAGTCGCA
AALS	TATTTATTTATTTATTTGTTTGTTTGTTTTATTTATTTATTTATTTATTTGTTTGTTTGTTTTATTATCGAGACTATACAAGGATCTACCTCAGTCGCACACAAGCAGAGGCTCTGGCAGCTTTTGCCAACA
AALp	TATTTATTTATTTATTTGTTTGTTTGTTTTATTTATTTATTTATTTATTTGTTTGTTTGTTTTATTATCGAGACTATACAAGGATCTACCTCAGTCGCAGTCAGCTCCGACTTGTAAATATCAGCCTCGACT
AASA	TATTTATTTATTTATTTGTTTGTTTGTTTTATTTATTTATTTATTTATTTGTTTGTTTGTTTTATTCACAAGCAGAGGCTCTGGCAGCTTTTGCCAACATATTTATTTATTTATTTGTTTGTTTGTTTTATT
AASB	TATTTATTTATTTATTTGTTTGTTTGTTTTATTTATTTATTTATTTATTTGTTTGTTTGTTTTATTCACAAGCAGAGGCTCTGGCAGCTTTTGCCAACAATCAGCCTCGACTGTGCCTTCTAGTTGCCAGCC
AASL	TATTTATTTATTTATTTGTTTGTTTGTTTTATTTATTTATTTATTTATTTGTTTGTTTGTTTTATTCACAAGCAGAGGCTCTGGCAGCTTTTGCCAACAATCGAGACTATACAAGGATCTACCTCAGTCGCA
AASS	TATTTATTTATTTATTTGTTTGTTTGTTTTATTTATTTATTTATTTATTTGTTTGTTTGTTTTATTCACAAGCAGAGGCTCTGGCAGCTTTTGCCAACACACAAGCAGAGGCTCTGGCAGCTTTTGCCAACA
AASp	TATTTATTTATTTATTTGTTTGTTTGTTTTATTTATTTATTTATTTATTTGTTTGTTTGTTTTATTCACAAGCAGAGGCTCTGGCAGCTTTTGCCAACAGTCAGCTCCGACTTGTAAATATCAGCCTCGACT
AApA	TATTTATTTATTTATTTGTTTGTTTGTTTTATTTATTTATTTATTTATTTGTTTGTTTGTTTTATTGTCAGCTCCGACTTGTAAATATCAGCCTCGACTTATTTATTTATTTATTTGTTTGTTTGTTTTATT
AApB	TATTTATTTATTTATTTGTTTGTTTGTTTTATTTATTTATTTATTTATTTGTTTGTTTGTTTTATTGTCAGCTCCGACTTGTAAATATCAGCCTCGACTATCAGCCTCGACTGTGCCTTCTAGTTGCCAGCC
AApL	TATTTATTTATTTATTTGTTTGTTTGTTTTATTTATTTATTTATTTATTTGTTTGTTTGTTTTATTGTCAGCTCCGACTTGTAAATATCAGCCTCGACTATCGAGACTATACAAGGATCTACCTCAGTCGCA
AApS	TATTTATTTATTTATTTGTTTGTTTGTTTTATTTATTTATTTATTTATTTGTTTGTTTGTTTTATTGTCAGCTCCGACTTGTAAATATCAGCCTCGACTCACAAGCAGAGGCTCTGGCAGCTTTTGCCAACA
AApp	TATTTATTTATTTATTTGTTTGTTTGTTTTATTTATTTATTTATTTATTTGTTTGTTTGTTTTATTGTCAGCTCCGACTTGTAAATATCAGCCTCGACTGTCAGCTCCGACTTGTAAATATCAGCCTCGACT
ABAA	TATTTATTTATTTATTTGTTTGTTTGTTTTATTATCAGCCTCGACTGTGCCTTCTAGTTGCCAGCCTATTTATTTATTTATTTGTTTGTTTGTTTTATTTATTTATTTATTTATTTGTTTGTTTGTTTTATT
ABAB	TATTTATTTATTTATTTGTTTGTTTGTTTTATTATCAGCCTCGACTGTGCCTTCTAGTTGCCAGCCTATTTATTTATTTATTTGTTTGTTTGTTTTATTATCAGCCTCGACTGTGCCTTCTAGTTGCCAGCC
ABAL	TATTTATTTATTTATTTGTTTGTTTGTTTTATTATCAGCCTCGACTGTGCCTTCTAGTTGCCAGCCTATTTATTTATTTATTTGTTTGTTTGTTTTATTATCGAGACTATACAAGGATCTACCTCAGTCGCA
ABAS	TATTTATTTATTTATTTGTTTGTTTGTTTTATTATCAGCCTCGACTGTGCCTTCTAGTTGCCAGCCTATTTATTTATTTATTTGTTTGTTTGTTTTATTCACAAGCAGAGGCTCTGGCAGCTTTTGCCAACA
ABAp	TATTTATTTATTTATTTGTTTGTTTGTTTTATTATCAGCCTCGACTGTGCCTTCTAGTTGCCAGCCTATTTATTTATTTATTTGTTTGTTTGTTTTATTGTCAGCTCCGACTTGTAAATATCAGCCTCGACT
ABBA	TATTTATTTATTTATTTGTTTGTTTGTTTTATTATCAGCCTCGACTGTGCCTTCTAGTTGCCAGCCATCAGCCTCGACTGTGCCTTCTAGTTGCCAGCCTATTTATTTATTTATTTGTTTGTTTGTTTTATT
ABBB	TATTTATTTATTTATTTGTTTGTTTGTTTTATTATCAGCCTCGACTGTGCCTTCTAGTTGCCAGCCATCAGCCTCGACTGTGCCTTCTAGTTGCCAGCCATCAGCCTCGACTGTGCCTTCTAGTTGCCAGCC
ABBL	TATTTATTTATTTATTTGTTTGTTTGTTTTATTATCAGCCTCGACTGTGCCTTCTAGTTGCCAGCCATCAGCCTCGACTGTGCCTTCTAGTTGCCAGCCATCGAGACTATACAAGGATCTACCTCAGTCGCA
ABBS	TATTTATTTATTTATTTGTTTGTTTGTTTTATTATCAGCCTCGACTGTGCCTTCTAGTTGCCAGCCATCAGCCTCGACTGTGCCTTCTAGTTGCCAGCCCACAAGCAGAGGCTCTGGCAGCTTTTGCCAACA
ABBp	TATTTATTTATTTATTTGTTTGTTTGTTTTATTATCAGCCTCGACTGTGCCTTCTAGTTGCCAGCCATCAGCCTCGACTGTGCCTTCTAGTTGCCAGCCGTCAGCTCCGACTTGTAAATATCAGCCTCGACT
ABLA	TATTTATTTATTTATTTGTTTGTTTGTTTTATTATCAGCCTCGACTGTGCCTTCTAGTTGCCAGCCATCGAGACTATACAAGGATCTACCTCAGTCGCATATTTATTTATTTATTTGTTTGTTTGTTTTATT
ABLB	TATTTATTTATTTATTTGTTTGTTTGTTTTATTATCAGCCTCGACTGTGCCTTCTAGTTGCCAGCCATCGAGACTATACAAGGATCTACCTCAGTCGCAATCAGCCTCGACTGTGCCTTCTAGTTGCCAGCC
ABLL	TATTTATTTATTTATTTGTTTGTTTGTTTTATTATCAGCCTCGACTGTGCCTTCTAGTTGCCAGCCATCGAGACTATACAAGGATCTACCTCAGTCGCAATCGAGACTATACAAGGATCTACCTCAGTCGCA
ABLS	TATTTATTTATTTATTTGTTTGTTTGTTTTATTATCAGCCTCGACTGTGCCTTCTAGTTGCCAGCCATCGAGACTATACAAGGATCTACCTCAGTCGCACACAAGCAGAGGCTCTGGCAGCTTTTGCCAACA
ABLp	TATTTATTTATTTATTTGTTTGTTTGTTTTATTATCAGCCTCGACTGTGCCTTCTAGTTGCCAGCCATCGAGACTATACAAGGATCTACCTCAGTCGCAGTCAGCTCCGACTTGTAAATATCAGCCTCGACT
ABSA	TATTTATTTATTTATTTGTTTGTTTGTTTTATTATCAGCCTCGACTGTGCCTTCTAGTTGCCAGCCCACAAGCAGAGGCTCTGGCAGCTTTTGCCAACATATTTATTTATTTATTTGTTTGTTTGTTTTATT
ABSB	TATTTATTTATTTATTTGTTTGTTTGTTTTATTATCAGCCTCGACTGTGCCTTCTAGTTGCCAGCCCACAAGCAGAGGCTCTGGCAGCTTTTGCCAACAATCAGCCTCGACTGTGCCTTCTAGTTGCCAGCC
ABSL	TATTTATTTATTTATTTGTTTGTTTGTTTTATTATCAGCCTCGACTGTGCCTTCTAGTTGCCAGCCCACAAGCAGAGGCTCTGGCAGCTTTTGCCAACAATCGAGACTATACAAGGATCTACCTCAGTCGCA
ABSS	TATTTATTTATTTATTTGTTTGTTTGTTTTATTATCAGCCTCGACTGTGCCTTCTAGTTGCCAGCCCACAAGCAGAGGCTCTGGCAGCTTTTGCCAACACACAAGCAGAGGCTCTGGCAGCTTTTGCCAACA
ABSp	TATTTATTTATTTATTTGTTTGTTTGTTTTATTATCAGCCTCGACTGTGCCTTCTAGTTGCCAGCCCACAAGCAGAGGCTCTGGCAGCTTTTGCCAACAGTCAGCTCCGACTTGTAAATATCAGCCTCGACT
ABpA	TATTTATTTATTTATTTGTTTGTTTGTTTTATTATCAGCCTCGACTGTGCCTTCTAGTTGCCAGCCGTCAGCTCCGACTTGTAAATATCAGCCTCGACTTATTTATTTATTTATTTGTTTGTTTGTTTTATT
ABpB	TATTTATTTATTTATTTGTTTGTTTGTTTTATTATCAGCCTCGACTGTGCCTTCTAGTTGCCAGCCGTCAGCTCCGACTTGTAAATATCAGCCTCGACTATCAGCCTCGACTGTGCCTTCTAGTTGCCAGCC
ABpL	TATTTATTTATTTATTTGTTTGTTTGTTTTATTATCAGCCTCGACTGTGCCTTCTAGTTGCCAGCCGTCAGCTCCGACTTGTAAATATCAGCCTCGACTATCGAGACTATACAAGGATCTACCTCAGTCGCA
ABpS	TATTTATTTATTTATTTGTTTGTTTGTTTTATTATCAGCCTCGACTGTGCCTTCTAGTTGCCAGCCGTCAGCTCCGACTTGTAAATATCAGCCTCGACTCACAAGCAGAGGCTCTGGCAGCTTTTGCCAACA
ABpp	TATTTATTTATTTATTTGTTTGTTTGTTTTATTATCAGCCTCGACTGTGCCTTCTAGTTGCCAGCCGTCAGCTCCGACTTGTAAATATCAGCCTCGACTGTCAGCTCCGACTTGTAAATATCAGCCTCGACT
ALAA	TATTTATTTATTTATTTGTTTGTTTGTTTTATTATCGAGACTATACAAGGATCTACCTCAGTCGCATATTTATTTATTTATTTGTTTGTTTGTTTTATTTATTTATTTATTTATTTGTTTGTTTGTTTTATT
ALAB	TATTTATTTATTTATTTGTTTGTTTGTTTTATTATCGAGACTATACAAGGATCTACCTCAGTCGCATATTTATTTATTTATTTGTTTGTTTGTTTTATTATCAGCCTCGACTGTGCCTTCTAGTTGCCAGCC
ALAL	TATTTATTTATTTATTTGTTTGTTTGTTTTATTATCGAGACTATACAAGGATCTACCTCAGTCGCATATTTATTTATTTATTTGTTTGTTTGTTTTATTATCGAGACTATACAAGGATCTACCTCAGTCGCA
ALAS	TATTTATTTATTTATTTGTTTGTTTGTTTTATTATCGAGACTATACAAGGATCTACCTCAGTCGCATATTTATTTATTTATTTGTTTGTTTGTTTTATTCACAAGCAGAGGCTCTGGCAGCTTTTGCCAACA
ALAp	TATTTATTTATTTATTTGTTTGTTTGTTTTATTATCGAGACTATACAAGGATCTACCTCAGTCGCATATTTATTTATTTATTTGTTTGTTTGTTTTATTGTCAGCTCCGACTTGTAAATATCAGCCTCGACT
ALBA	TATTTATTTATTTATTTGTTTGTTTGTTTTATTATCGAGACTATACAAGGATCTACCTCAGTCGCAATCAGCCTCGACTGTGCCTTCTAGTTGCCAGCCTATTTATTTATTTATTTGTTTGTTTGTTTTATT
ALBB	TATTTATTTATTTATTTGTTTGTTTGTTTTATTATCGAGACTATACAAGGATCTACCTCAGTCGCAATCAGCCTCGACTGTGCCTTCTAGTTGCCAGCCATCAGCCTCGACTGTGCCTTCTAGTTGCCAGCC
ALBL	TATTTATTTATTTATTTGTTTGTTTGTTTTATTATCGAGACTATACAAGGATCTACCTCAGTCGCAATCAGCCTCGACTGTGCCTTCTAGTTGCCAGCCATCGAGACTATACAAGGATCTACCTCAGTCGCA
ALBS	TATTTATTTATTTATTTGTTTGTTTGTTTTATTATCGAGACTATACAAGGATCTACCTCAGTCGCAATCAGCCTCGACTGTGCCTTCTAGTTGCCAGCCCACAAGCAGAGGCTCTGGCAGCTTTTGCCAACA
ALBp	TATTTATTTATTTATTTGTTTGTTTGTTTTATTATCGAGACTATACAAGGATCTACCTCAGTCGCAATCAGCCTCGACTGTGCCTTCTAGTTGCCAGCCGTCAGCTCCGACTTGTAAATATCAGCCTCGACT
ALLA	TATTTATTTATTTATTTGTTTGTTTGTTTTATTATCGAGACTATACAAGGATCTACCTCAGTCGCAATCGAGACTATACAAGGATCTACCTCAGTCGCATATTTATTTATTTATTTGTTTGTTTGTTTTATT
ALLB	TATTTATTTATTTATTTGTTTGTTTGTTTTATTATCGAGACTATACAAGGATCTACCTCAGTCGCAATCGAGACTATACAAGGATCTACCTCAGTCGCAATCAGCCTCGACTGTGCCTTCTAGTTGCCAGCC
ALLL	TATTTATTTATTTATTTGTTTGTTTGTTTTATTATCGAGACTATACAAGGATCTACCTCAGTCGCAATCGAGACTATACAAGGATCTACCTCAGTCGCAATCGAGACTATACAAGGATCTACCTCAGTCGCA
ALLS	TATTTATTTATTTATTTGTTTGTTTGTTTTATTATCGAGACTATACAAGGATCTACCTCAGTCGCAATCGAGACTATACAAGGATCTACCTCAGTCGCACACAAGCAGAGGCTCTGGCAGCTTTTGCCAACA
ALLp	TATTTATTTATTTATTTGTTTGTTTGTTTTATTATCGAGACTATACAAGGATCTACCTCAGTCGCAATCGAGACTATACAAGGATCTACCTCAGTCGCAGTCAGCTCCGACTTGTAAATATCAGCCTCGACT
ALSA	TATTTATTTATTTATTTGTTTGTTTGTTTTATTATCGAGACTATACAAGGATCTACCTCAGTCGCACACAAGCAGAGGCTCTGGCAGCTTTTGCCAACATATTTATTTATTTATTTGTTTGTTTGTTTTATT
ALSB	TATTTATTTATTTATTTGTTTGTTTGTTTTATTATCGAGACTATACAAGGATCTACCTCAGTCGCACACAAGCAGAGGCTCTGGCAGCTTTTGCCAACAATCAGCCTCGACTGTGCCTTCTAGTTGCCAGCC
ALSL	TATTTATTTATTTATTTGTTTGTTTGTTTTATTATCGAGACTATACAAGGATCTACCTCAGTCGCACACAAGCAGAGGCTCTGGCAGCTTTTGCCAACAATCGAGACTATACAAGGATCTACCTCAGTCGCA
ALSS	TATTTATTTATTTATTTGTTTGTTTGTTTTATTATCGAGACTATACAAGGATCTACCTCAGTCGCACACAAGCAGAGGCTCTGGCAGCTTTTGCCAACACACAAGCAGAGGCTCTGGCAGCTTTTGCCAACA
ALSp	TATTTATTTATTTATTTGTTTGTTTGTTTTATTATCGAGACTATACAAGGATCTACCTCAGTCGCACACAAGCAGAGGCTCTGGCAGCTTTTGCCAACAGTCAGCTCCGACTTGTAAATATCAGCCTCGACT
ALpA	TATTTATTTATTTATTTGTTTGTTTGTTTTATTATCGAGACTATACAAGGATCTACCTCAGTCGCAGTCAGCTCCGACTTGTAAATATCAGCCTCGACTTATTTATTTATTTATTTGTTTGTTTGTTTTATT
ALpB	TATTTATTTATTTATTTGTTTGTTTGTTTTATTATCGAGACTATACAAGGATCTACCTCAGTCGCAGTCAGCTCCGACTTGTAAATATCAGCCTCGACTATCAGCCTCGACTGTGCCTTCTAGTTGCCAGCC
ALpL	TATTTATTTATTTATTTGTTTGTTTGTTTTATTATCGAGACTATACAAGGATCTACCTCAGTCGCAGTCAGCTCCGACTTGTAAATATCAGCCTCGACTATCGAGACTATACAAGGATCTACCTCAGTCGCA
ALpS	TATTTATTTATTTATTTGTTTGTTTGTTTTATTATCGAGACTATACAAGGATCTACCTCAGTCGCAGTCAGCTCCGACTTGTAAATATCAGCCTCGACTCACAAGCAGAGGCTCTGGCAGCTTTTGCCAACA
ALpp	TATTTATTTATTTATTTGTTTGTTTGTTTTATTATCGAGACTATACAAGGATCTACCTCAGTCGCAGTCAGCTCCGACTTGTAAATATCAGCCTCGACTGTCAGCTCCGACTTGTAAATATCAGCCTCGACT
ASAA	TATTTATTTATTTATTTGTTTGTTTGTTTTATTCACAAGCAGAGGCTCTGGCAGCTTTTGCCAACATATTTATTTATTTATTTGTTTGTTTGTTTTATTTATTTATTTATTTATTTGTTTGTTTGTTTTATT
ASAB	TATTTATTTATTTATTTGTTTGTTTGTTTTATTCACAAGCAGAGGCTCTGGCAGCTTTTGCCAACATATTTATTTATTTATTTGTTTGTTTGTTTTATTATCAGCCTCGACTGTGCCTTCTAGTTGCCAGCC
ASAL	TATTTATTTATTTATTTGTTTGTTTGTTTTATTCACAAGCAGAGGCTCTGGCAGCTTTTGCCAACATATTTATTTATTTATTTGTTTGTTTGTTTTATTATCGAGACTATACAAGGATCTACCTCAGTCGCA
ASAS	TATTTATTTATTTATTTGTTTGTTTGTTTTATTCACAAGCAGAGGCTCTGGCAGCTTTTGCCAACATATTTATTTATTTATTTGTTTGTTTGTTTTATTCACAAGCAGAGGCTCTGGCAGCTTTTGCCAACA
ASAp	TATTTATTTATTTATTTGTTTGTTTGTTTTATTCACAAGCAGAGGCTCTGGCAGCTTTTGCCAACATATTTATTTATTTATTTGTTTGTTTGTTTTATTGTCAGCTCCGACTTGTAAATATCAGCCTCGACT
ASBA	TATTTATTTATTTATTTGTTTGTTTGTTTTATTCACAAGCAGAGGCTCTGGCAGCTTTTGCCAACAATCAGCCTCGACTGTGCCTTCTAGTTGCCAGCCTATTTATTTATTTATTTGTTTGTTTGTTTTATT
ASBB	TATTTATTTATTTATTTGTTTGTTTGTTTTATTCACAAGCAGAGGCTCTGGCAGCTTTTGCCAACAATCAGCCTCGACTGTGCCTTCTAGTTGCCAGCCATCAGCCTCGACTGTGCCTTCTAGTTGCCAGCC
ASBL	TATTTATTTATTTATTTGTTTGTTTGTTTTATTCACAAGCAGAGGCTCTGGCAGCTTTTGCCAACAATCAGCCTCGACTGTGCCTTCTAGTTGCCAGCCATCGAGACTATACAAGGATCTACCTCAGTCGCA
ASBS	TATTTATTTATTTATTTGTTTGTTTGTTTTATTCACAAGCAGAGGCTCTGGCAGCTTTTGCCAACAATCAGCCTCGACTGTGCCTTCTAGTTGCCAGCCCACAAGCAGAGGCTCTGGCAGCTTTTGCCAACA
ASBp	TATTTATTTATTTATTTGTTTGTTTGTTTTATTCACAAGCAGAGGCTCTGGCAGCTTTTGCCAACAATCAGCCTCGACTGTGCCTTCTAGTTGCCAGCCGTCAGCTCCGACTTGTAAATATCAGCCTCGACT
ASLA	TATTTATTTATTTATTTGTTTGTTTGTTTTATTCACAAGCAGAGGCTCTGGCAGCTTTTGCCAACAATCGAGACTATACAAGGATCTACCTCAGTCGCATATTTATTTATTTATTTGTTTGTTTGTTTTATT
ASLB	TATTTATTTATTTATTTGTTTGTTTGTTTTATTCACAAGCAGAGGCTCTGGCAGCTTTTGCCAACAATCGAGACTATACAAGGATCTACCTCAGTCGCAATCAGCCTCGACTGTGCCTTCTAGTTGCCAGCC
ASLL	TATTTATTTATTTATTTGTTTGTTTGTTTTATTCACAAGCAGAGGCTCTGGCAGCTTTTGCCAACAATCGAGACTATACAAGGATCTACCTCAGTCGCAATCGAGACTATACAAGGATCTACCTCAGTCGCA
ASLS	TATTTATTTATTTATTTGTTTGTTTGTTTTATTCACAAGCAGAGGCTCTGGCAGCTTTTGCCAACAATCGAGACTATACAAGGATCTACCTCAGTCGCACACAAGCAGAGGCTCTGGCAGCTTTTGCCAACA
ASLp	TATTTATTTATTTATTTGTTTGTTTGTTTTATTCACAAGCAGAGGCTCTGGCAGCTTTTGCCAACAATCGAGACTATACAAGGATCTACCTCAGTCGCAGTCAGCTCCGACTTGTAAATATCAGCCTCGACT
ASSA	TATTTATTTATTTATTTGTTTGTTTGTTTTATTCACAAGCAGAGGCTCTGGCAGCTTTTGCCAACACACAAGCAGAGGCTCTGGCAGCTTTTGCCAACATATTTATTTATTTATTTGTTTGTTTGTTTTATT
ASSB	TATTTATTTATTTATTTGTTTGTTTGTTTTATTCACAAGCAGAGGCTCTGGCAGCTTTTGCCAACACACAAGCAGAGGCTCTGGCAGCTTTTGCCAACAATCAGCCTCGACTGTGCCTTCTAGTTGCCAGCC
ASSL	TATTTATTTATTTATTTGTTTGTTTGTTTTATTCACAAGCAGAGGCTCTGGCAGCTTTTGCCAACACACAAGCAGAGGCTCTGGCAGCTTTTGCCAACAATCGAGACTATACAAGGATCTACCTCAGTCGCA
ASSS	TATTTATTTATTTATTTGTTTGTTTGTTTTATTCACAAGCAGAGGCTCTGGCAGCTTTTGCCAACACACAAGCAGAGGCTCTGGCAGCTTTTGCCAACACACAAGCAGAGGCTCTGGCAGCTTTTGCCAACA
ASSp	TATTTATTTATTTATTTGTTTGTTTGTTTTATTCACAAGCAGAGGCTCTGGCAGCTTTTGCCAACACACAAGCAGAGGCTCTGGCAGCTTTTGCCAACAGTCAGCTCCGACTTGTAAATATCAGCCTCGACT
ASpA	TATTTATTTATTTATTTGTTTGTTTGTTTTATTCACAAGCAGAGGCTCTGGCAGCTTTTGCCAACAGTCAGCTCCGACTTGTAAATATCAGCCTCGACTTATTTATTTATTTATTTGTTTGTTTGTTTTATT
ASpB	TATTTATTTATTTATTTGTTTGTTTGTTTTATTCACAAGCAGAGGCTCTGGCAGCTTTTGCCAACAGTCAGCTCCGACTTGTAAATATCAGCCTCGACTATCAGCCTCGACTGTGCCTTCTAGTTGCCAGCC
ASpL	TATTTATTTATTTATTTGTTTGTTTGTTTTATTCACAAGCAGAGGCTCTGGCAGCTTTTGCCAACAGTCAGCTCCGACTTGTAAATATCAGCCTCGACTATCGAGACTATACAAGGATCTACCTCAGTCGCA
ASpS	TATTTATTTATTTATTTGTTTGTTTGTTTTATTCACAAGCAGAGGCTCTGGCAGCTTTTGCCAACAGTCAGCTCCGACTTGTAAATATCAGCCTCGACTCACAAGCAGAGGCTCTGGCAGCTTTTGCCAACA
ASpp	TATTTATTTATTTATTTGTTTGTTTGTTTTATTCACAAGCAGAGGCTCTGGCAGCTTTTGCCAACAGTCAGCTCCGACTTGTAAATATCAGCCTCGACTGTCAGCTCCGACTTGTAAATATCAGCCTCGACT
ApAA	TATTTATTTATTTATTTGTTTGTTTGTTTTATTGTCAGCTCCGACTTGTAAATATCAGCCTCGACTTATTTATTTATTTATTTGTTTGTTTGTTTTATTTATTTATTTATTTATTTGTTTGTTTGTTTTATT
ApAB	TATTTATTTATTTATTTGTTTGTTTGTTTTATTGTCAGCTCCGACTTGTAAATATCAGCCTCGACTTATTTATTTATTTATTTGTTTGTTTGTTTTATTATCAGCCTCGACTGTGCCTTCTAGTTGCCAGCC
ApAL	TATTTATTTATTTATTTGTTTGTTTGTTTTATTGTCAGCTCCGACTTGTAAATATCAGCCTCGACTTATTTATTTATTTATTTGTTTGTTTGTTTTATTATCGAGACTATACAAGGATCTACCTCAGTCGCA
ApAS	TATTTATTTATTTATTTGTTTGTTTGTTTTATTGTCAGCTCCGACTTGTAAATATCAGCCTCGACTTATTTATTTATTTATTTGTTTGTTTGTTTTATTCACAAGCAGAGGCTCTGGCAGCTTTTGCCAACA
ApAp	TATTTATTTATTTATTTGTTTGTTTGTTTTATTGTCAGCTCCGACTTGTAAATATCAGCCTCGACTTATTTATTTATTTATTTGTTTGTTTGTTTTATTGTCAGCTCCGACTTGTAAATATCAGCCTCGACT
ApBA	TATTTATTTATTTATTTGTTTGTTTGTTTTATTGTCAGCTCCGACTTGTAAATATCAGCCTCGACTATCAGCCTCGACTGTGCCTTCTAGTTGCCAGCCTATTTATTTATTTATTTGTTTGTTTGTTTTATT
ApBB	TATTTATTTATTTATTTGTTTGTTTGTTTTATTGTCAGCTCCGACTTGTAAATATCAGCCTCGACTATCAGCCTCGACTGTGCCTTCTAGTTGCCAGCCATCAGCCTCGACTGTGCCTTCTAGTTGCCAGCC
ApBL	TATTTATTTATTTATTTGTTTGTTTGTTTTATTGTCAGCTCCGACTTGTAAATATCAGCCTCGACTATCAGCCTCGACTGTGCCTTCTAGTTGCCAGCCATCGAGACTATACAAGGATCTACCTCAGTCGCA
ApBS	TATTTATTTATTTATTTGTTTGTTTGTTTTATTGTCAGCTCCGACTTGTAAATATCAGCCTCGACTATCAGCCTCGACTGTGCCTTCTAGTTGCCAGCCCACAAGCAGAGGCTCTGGCAGCTTTTGCCAACA
ApBp	TATTTATTTATTTATTTGTTTGTTTGTTTTATTGTCAGCTCCGACTTGTAAATATCAGCCTCGACTATCAGCCTCGACTGTGCCTTCTAGTTGCCAGCCGTCAGCTCCGACTTGTAAATATCAGCCTCGACT
ApLA	TATTTATTTATTTATTTGTTTGTTTGTTTTATTGTCAGCTCCGACTTGTAAATATCAGCCTCGACTATCGAGACTATACAAGGATCTACCTCAGTCGCATATTTATTTATTTATTTGTTTGTTTGTTTTATT
ApLB	TATTTATTTATTTATTTGTTTGTTTGTTTTATTGTCAGCTCCGACTTGTAAATATCAGCCTCGACTATCGAGACTATACAAGGATCTACCTCAGTCGCAATCAGCCTCGACTGTGCCTTCTAGTTGCCAGCC
ApLL	TATTTATTTATTTATTTGTTTGTTTGTTTTATTGTCAGCTCCGACTTGTAAATATCAGCCTCGACTATCGAGACTATACAAGGATCTACCTCAGTCGCAATCGAGACTATACAAGGATCTACCTCAGTCGCA
ApLS	TATTTATTTATTTATTTGTTTGTTTGTTTTATTGTCAGCTCCGACTTGTAAATATCAGCCTCGACTATCGAGACTATACAAGGATCTACCTCAGTCGCACACAAGCAGAGGCTCTGGCAGCTTTTGCCAACA
ApLp	TATTTATTTATTTATTTGTTTGTTTGTTTTATTGTCAGCTCCGACTTGTAAATATCAGCCTCGACTATCGAGACTATACAAGGATCTACCTCAGTCGCAGTCAGCTCCGACTTGTAAATATCAGCCTCGACT
ApSA	TATTTATTTATTTATTTGTTTGTTTGTTTTATTGTCAGCTCCGACTTGTAAATATCAGCCTCGACTCACAAGCAGAGGCTCTGGCAGCTTTTGCCAACATATTTATTTATTTATTTGTTTGTTTGTTTTATT
ApSB	TATTTATTTATTTATTTGTTTGTTTGTTTTATTGTCAGCTCCGACTTGTAAATATCAGCCTCGACTCACAAGCAGAGGCTCTGGCAGCTTTTGCCAACAATCAGCCTCGACTGTGCCTTCTAGTTGCCAGCC
ApSL	TATTTATTTATTTATTTGTTTGTTTGTTTTATTGTCAGCTCCGACTTGTAAATATCAGCCTCGACTCACAAGCAGAGGCTCTGGCAGCTTTTGCCAACAATCGAGACTATACAAGGATCTACCTCAGTCGCA
ApSS	TATTTATTTATTTATTTGTTTGTTTGTTTTATTGTCAGCTCCGACTTGTAAATATCAGCCTCGACTCACAAGCAGAGGCTCTGGCAGCTTTTGCCAACACACAAGCAGAGGCTCTGGCAGCTTTTGCCAACA
ApSp	TATTTATTTATTTATTTGTTTGTTTGTTTTATTGTCAGCTCCGACTTGTAAATATCAGCCTCGACTCACAAGCAGAGGCTCTGGCAGCTTTTGCCAACAGTCAGCTCCGACTTGTAAATATCAGCCTCGACT
AppA	TATTTATTTATTTATTTGTTTGTTTGTTTTATTGTCAGCTCCGACTTGTAAATATCAGCCTCGACTGTCAGCTCCGACTTGTAAATATCAGCCTCGACTTATTTATTTATTTATTTGTTTGTTTGTTTTATT
AppB	TATTTATTTATTTATTTGTTTGTTTGTTTTATTGTCAGCTCCGACTTGTAAATATCAGCCTCGACTGTCAGCTCCGACTTGTAAATATCAGCCTCGACTATCAGCCTCGACTGTGCCTTCTAGTTGCCAGCC
AppL	TATTTATTTATTTATTTGTTTGTTTGTTTTATTGTCAGCTCCGACTTGTAAATATCAGCCTCGACTGTCAGCTCCGACTTGTAAATATCAGCCTCGACTATCGAGACTATACAAGGATCTACCTCAGTCGCA
AppS	TATTTATTTATTTATTTGTTTGTTTGTTTTATTGTCAGCTCCGACTTGTAAATATCAGCCTCGACTGTCAGCTCCGACTTGTAAATATCAGCCTCGACTCACAAGCAGAGGCTCTGGCAGCTTTTGCCAACA
Appp	TATTTATTTATTTATTTGTTTGTTTGTTTTATTGTCAGCTCCGACTTGTAAATATCAGCCTCGACTGTCAGCTCCGACTTGTAAATATCAGCCTCGACTGTCAGCTCCGACTTGTAAATATCAGCCTCGACT
BAAA	ATCAGCCTCGACTGTGCCTTCTAGTTGCCAGCCTATTTATTTATTTATTTGTTTGTTTGTTTTATTTATTTATTTATTTATTTGTTTGTTTGTTTTATTTATTTATTTATTTATTTGTTTGTTTGTTTTATT
BAAB	ATCAGCCTCGACTGTGCCTTCTAGTTGCCAGCCTATTTATTTATTTATTTGTTTGTTTGTTTTATTTATTTATTTATTTATTTGTTTGTTTGTTTTATTATCAGCCTCGACTGTGCCTTCTAGTTGCCAGCC
BAAL	ATCAGCCTCGACTGTGCCTTCTAGTTGCCAGCCTATTTATTTATTTATTTGTTTGTTTGTTTTATTTATTTATTTATTTATTTGTTTGTTTGTTTTATTATCGAGACTATACAAGGATCTACCTCAGTCGCA
BAAS	ATCAGCCTCGACTGTGCCTTCTAGTTGCCAGCCTATTTATTTATTTATTTGTTTGTTTGTTTTATTTATTTATTTATTTATTTGTTTGTTTGTTTTATTCACAAGCAGAGGCTCTGGCAGCTTTTGCCAACA
BAAp	ATCAGCCTCGACTGTGCCTTCTAGTTGCCAGCCTATTTATTTATTTATTTGTTTGTTTGTTTTATTTATTTATTTATTTATTTGTTTGTTTGTTTTATTGTCAGCTCCGACTTGTAAATATCAGCCTCGACT
BABA	ATCAGCCTCGACTGTGCCTTCTAGTTGCCAGCCTATTTATTTATTTATTTGTTTGTTTGTTTTATTATCAGCCTCGACTGTGCCTTCTAGTTGCCAGCCTATTTATTTATTTATTTGTTTGTTTGTTTTATT
BABB	ATCAGCCTCGACTGTGCCTTCTAGTTGCCAGCCTATTTATTTATTTATTTGTTTGTTTGTTTTATTATCAGCCTCGACTGTGCCTTCTAGTTGCCAGCCATCAGCCTCGACTGTGCCTTCTAGTTGCCAGCC
BABL	ATCAGCCTCGACTGTGCCTTCTAGTTGCCAGCCTATTTATTTATTTATTTGTTTGTTTGTTTTATTATCAGCCTCGACTGTGCCTTCTAGTTGCCAGCCATCGAGACTATACAAGGATCTACCTCAGTCGCA
BABS	ATCAGCCTCGACTGTGCCTTCTAGTTGCCAGCCTATTTATTTATTTATTTGTTTGTTTGTTTTATTATCAGCCTCGACTGTGCCTTCTAGTTGCCAGCCCACAAGCAGAGGCTCTGGCAGCTTTTGCCAACA
BABp	ATCAGCCTCGACTGTGCCTTCTAGTTGCCAGCCTATTTATTTATTTATTTGTTTGTTTGTTTTATTATCAGCCTCGACTGTGCCTTCTAGTTGCCAGCCGTCAGCTCCGACTTGTAAATATCAGCCTCGACT
BALA	ATCAGCCTCGACTGTGCCTTCTAGTTGCCAGCCTATTTATTTATTTATTTGTTTGTTTGTTTTATTATCGAGACTATACAAGGATCTACCTCAGTCGCATATTTATTTATTTATTTGTTTGTTTGTTTTATT
BALB	ATCAGCCTCGACTGTGCCTTCTAGTTGCCAGCCTATTTATTTATTTATTTGTTTGTTTGTTTTATTATCGAGACTATACAAGGATCTACCTCAGTCGCAATCAGCCTCGACTGTGCCTTCTAGTTGCCAGCC
BALL	ATCAGCCTCGACTGTGCCTTCTAGTTGCCAGCCTATTTATTTATTTATTTGTTTGTTTGTTTTATTATCGAGACTATACAAGGATCTACCTCAGTCGCAATCGAGACTATACAAGGATCTACCTCAGTCGCA
BALS	ATCAGCCTCGACTGTGCCTTCTAGTTGCCAGCCTATTTATTTATTTATTTGTTTGTTTGTTTTATTATCGAGACTATACAAGGATCTACCTCAGTCGCACACAAGCAGAGGCTCTGGCAGCTTTTGCCAACA
BALp	ATCAGCCTCGACTGTGCCTTCTAGTTGCCAGCCTATTTATTTATTTATTTGTTTGTTTGTTTTATTATCGAGACTATACAAGGATCTACCTCAGTCGCAGTCAGCTCCGACTTGTAAATATCAGCCTCGACT
BASA	ATCAGCCTCGACTGTGCCTTCTAGTTGCCAGCCTATTTATTTATTTATTTGTTTGTTTGTTTTATTCACAAGCAGAGGCTCTGGCAGCTTTTGCCAACATATTTATTTATTTATTTGTTTGTTTGTTTTATT
BASB	ATCAGCCTCGACTGTGCCTTCTAGTTGCCAGCCTATTTATTTATTTATTTGTTTGTTTGTTTTATTCACAAGCAGAGGCTCTGGCAGCTTTTGCCAACAATCAGCCTCGACTGTGCCTTCTAGTTGCCAGCC
BASL	ATCAGCCTCGACTGTGCCTTCTAGTTGCCAGCCTATTTATTTATTTATTTGTTTGTTTGTTTTATTCACAAGCAGAGGCTCTGGCAGCTTTTGCCAACAATCGAGACTATACAAGGATCTACCTCAGTCGCA
BASS	ATCAGCCTCGACTGTGCCTTCTAGTTGCCAGCCTATTTATTTATTTATTTGTTTGTTTGTTTTATTCACAAGCAGAGGCTCTGGCAGCTTTTGCCAACACACAAGCAGAGGCTCTGGCAGCTTTTGCCAACA
BASp	ATCAGCCTCGACTGTGCCTTCTAGTTGCCAGCCTATTTATTTATTTATTTGTTTGTTTGTTTTATTCACAAGCAGAGGCTCTGGCAGCTTTTGCCAACAGTCAGCTCCGACTTGTAAATATCAGCCTCGACT
BApA	ATCAGCCTCGACTGTGCCTTCTAGTTGCCAGCCTATTTATTTATTTATTTGTTTGTTTGTTTTATTGTCAGCTCCGACTTGTAAATATCAGCCTCGACTTATTTATTTATTTATTTGTTTGTTTGTTTTATT
BApB	ATCAGCCTCGACTGTGCCTTCTAGTTGCCAGCCTATTTATTTATTTATTTGTTTGTTTGTTTTATTGTCAGCTCCGACTTGTAAATATCAGCCTCGACTATCAGCCTCGACTGTGCCTTCTAGTTGCCAGCC
BApL	ATCAGCCTCGACTGTGCCTTCTAGTTGCCAGCCTATTTATTTATTTATTTGTTTGTTTGTTTTATTGTCAGCTCCGACTTGTAAATATCAGCCTCGACTATCGAGACTATACAAGGATCTACCTCAGTCGCA
BApS	ATCAGCCTCGACTGTGCCTTCTAGTTGCCAGCCTATTTATTTATTTATTTGTTTGTTTGTTTTATTGTCAGCTCCGACTTGTAAATATCAGCCTCGACTCACAAGCAGAGGCTCTGGCAGCTTTTGCCAACA
BApp	ATCAGCCTCGACTGTGCCTTCTAGTTGCCAGCCTATTTATTTATTTATTTGTTTGTTTGTTTTATTGTCAGCTCCGACTTGTAAATATCAGCCTCGACTGTCAGCTCCGACTTGTAAATATCAGCCTCGACT
BBAA	ATCAGCCTCGACTGTGCCTTCTAGTTGCCAGCCATCAGCCTCGACTGTGCCTTCTAGTTGCCAGCCTATTTATTTATTTATTTGTTTGTTTGTTTTATTTATTTATTTATTTATTTGTTTGTTTGTTTTATT
BBAB	ATCAGCCTCGACTGTGCCTTCTAGTTGCCAGCCATCAGCCTCGACTGTGCCTTCTAGTTGCCAGCCTATTTATTTATTTATTTGTTTGTTTGTTTTATTATCAGCCTCGACTGTGCCTTCTAGTTGCCAGCC
BBAL	ATCAGCCTCGACTGTGCCTTCTAGTTGCCAGCCATCAGCCTCGACTGTGCCTTCTAGTTGCCAGCCTATTTATTTATTTATTTGTTTGTTTGTTTTATTATCGAGACTATACAAGGATCTACCTCAGTCGCA
BBAS	ATCAGCCTCGACTGTGCCTTCTAGTTGCCAGCCATCAGCCTCGACTGTGCCTTCTAGTTGCCAGCCTATTTATTTATTTATTTGTTTGTTTGTTTTATTCACAAGCAGAGGCTCTGGCAGCTTTTGCCAACA
BBAp	ATCAGCCTCGACTGTGCCTTCTAGTTGCCAGCCATCAGCCTCGACTGTGCCTTCTAGTTGCCAGCCTATTTATTTATTTATTTGTTTGTTTGTTTTATTGTCAGCTCCGACTTGTAAATATCAGCCTCGACT
BBBA	ATCAGCCTCGACTGTGCCTTCTAGTTGCCAGCCATCAGCCTCGACTGTGCCTTCTAGTTGCCAGCCATCAGCCTCGACTGTGCCTTCTAGTTGCCAGCCTATTTATTTATTTATTTGTTTGTTTGTTTTATT
BBBB	ATCAGCCTCGACTGTGCCTTCTAGTTGCCAGCCATCAGCCTCGACTGTGCCTTCTAGTTGCCAGCCATCAGCCTCGACTGTGCCTTCTAGTTGCCAGCCATCAGCCTCGACTGTGCCTTCTAGTTGCCAGCC
BBBL	ATCAGCCTCGACTGTGCCTTCTAGTTGCCAGCCATCAGCCTCGACTGTGCCTTCTAGTTGCCAGCCATCAGCCTCGACTGTGCCTTCTAGTTGCCAGCCATCGAGACTATACAAGGATCTACCTCAGTCGCA
BBBS	ATCAGCCTCGACTGTGCCTTCTAGTTGCCAGCCATCAGCCTCGACTGTGCCTTCTAGTTGCCAGCCATCAGCCTCGACTGTGCCTTCTAGTTGCCAGCCCACAAGCAGAGGCTCTGGCAGCTTTTGCCAACA
BBBp	ATCAGCCTCGACTGTGCCTTCTAGTTGCCAGCCATCAGCCTCGACTGTGCCTTCTAGTTGCCAGCCATCAGCCTCGACTGTGCCTTCTAGTTGCCAGCCGTCAGCTCCGACTTGTAAATATCAGCCTCGACT
BBLA	ATCAGCCTCGACTGTGCCTTCTAGTTGCCAGCCATCAGCCTCGACTGTGCCTTCTAGTTGCCAGCCATCGAGACTATACAAGGATCTACCTCAGTCGCATATTTATTTATTTATTTGTTTGTTTGTTTTATT
BBLB	ATCAGCCTCGACTGTGCCTTCTAGTTGCCAGCCATCAGCCTCGACTGTGCCTTCTAGTTGCCAGCCATCGAGACTATACAAGGATCTACCTCAGTCGCAATCAGCCTCGACTGTGCCTTCTAGTTGCCAGCC
BBLL	ATCAGCCTCGACTGTGCCTTCTAGTTGCCAGCCATCAGCCTCGACTGTGCCTTCTAGTTGCCAGCCATCGAGACTATACAAGGATCTACCTCAGTCGCAATCGAGACTATACAAGGATCTACCTCAGTCGCA
BBLS	ATCAGCCTCGACTGTGCCTTCTAGTTGCCAGCCATCAGCCTCGACTGTGCCTTCTAGTTGCCAGCCATCGAGACTATACAAGGATCTACCTCAGTCGCACACAAGCAGAGGCTCTGGCAGCTTTTGCCAACA
BBLp	ATCAGCCTCGACTGTGCCTTCTAGTTGCCAGCCATCAGCCTCGACTGTGCCTTCTAGTTGCCAGCCATCGAGACTATACAAGGATCTACCTCAGTCGCAGTCAGCTCCGACTTGTAAATATCAGCCTCGACT
BBSA	ATCAGCCTCGACTGTGCCTTCTAGTTGCCAGCCATCAGCCTCGACTGTGCCTTCTAGTTGCCAGCCCACAAGCAGAGGCTCTGGCAGCTTTTGCCAACATATTTATTTATTTATTTGTTTGTTTGTTTTATT
BBSB	ATCAGCCTCGACTGTGCCTTCTAGTTGCCAGCCATCAGCCTCGACTGTGCCTTCTAGTTGCCAGCCCACAAGCAGAGGCTCTGGCAGCTTTTGCCAACAATCAGCCTCGACTGTGCCTTCTAGTTGCCAGCC
BBSL	ATCAGCCTCGACTGTGCCTTCTAGTTGCCAGCCATCAGCCTCGACTGTGCCTTCTAGTTGCCAGCCCACAAGCAGAGGCTCTGGCAGCTTTTGCCAACAATCGAGACTATACAAGGATCTACCTCAGTCGCA
BBSS	ATCAGCCTCGACTGTGCCTTCTAGTTGCCAGCCATCAGCCTCGACTGTGCCTTCTAGTTGCCAGCCCACAAGCAGAGGCTCTGGCAGCTTTTGCCAACACACAAGCAGAGGCTCTGGCAGCTTTTGCCAACA
BBSp	ATCAGCCTCGACTGTGCCTTCTAGTTGCCAGCCATCAGCCTCGACTGTGCCTTCTAGTTGCCAGCCCACAAGCAGAGGCTCTGGCAGCTTTTGCCAACAGTCAGCTCCGACTTGTAAATATCAGCCTCGACT
BBpA	ATCAGCCTCGACTGTGCCTTCTAGTTGCCAGCCATCAGCCTCGACTGTGCCTTCTAGTTGCCAGCCGTCAGCTCCGACTTGTAAATATCAGCCTCGACTTATTTATTTATTTATTTGTTTGTTTGTTTTATT
BBpB	ATCAGCCTCGACTGTGCCTTCTAGTTGCCAGCCATCAGCCTCGACTGTGCCTTCTAGTTGCCAGCCGTCAGCTCCGACTTGTAAATATCAGCCTCGACTATCAGCCTCGACTGTGCCTTCTAGTTGCCAGCC
BBpL	ATCAGCCTCGACTGTGCCTTCTAGTTGCCAGCCATCAGCCTCGACTGTGCCTTCTAGTTGCCAGCCGTCAGCTCCGACTTGTAAATATCAGCCTCGACTATCGAGACTATACAAGGATCTACCTCAGTCGCA
BBpS	ATCAGCCTCGACTGTGCCTTCTAGTTGCCAGCCATCAGCCTCGACTGTGCCTTCTAGTTGCCAGCCGTCAGCTCCGACTTGTAAATATCAGCCTCGACTCACAAGCAGAGGCTCTGGCAGCTTTTGCCAACA
BBpp	ATCAGCCTCGACTGTGCCTTCTAGTTGCCAGCCATCAGCCTCGACTGTGCCTTCTAGTTGCCAGCCGTCAGCTCCGACTTGTAAATATCAGCCTCGACTGTCAGCTCCGACTTGTAAATATCAGCCTCGACT
BLAA	ATCAGCCTCGACTGTGCCTTCTAGTTGCCAGCCATCGAGACTATACAAGGATCTACCTCAGTCGCATATTTATTTATTTATTTGTTTGTTTGTTTTATTTATTTATTTATTTATTTGTTTGTTTGTTTTATT
BLAB	ATCAGCCTCGACTGTGCCTTCTAGTTGCCAGCCATCGAGACTATACAAGGATCTACCTCAGTCGCATATTTATTTATTTATTTGTTTGTTTGTTTTATTATCAGCCTCGACTGTGCCTTCTAGTTGCCAGCC
BLAL	ATCAGCCTCGACTGTGCCTTCTAGTTGCCAGCCATCGAGACTATACAAGGATCTACCTCAGTCGCATATTTATTTATTTATTTGTTTGTTTGTTTTATTATCGAGACTATACAAGGATCTACCTCAGTCGCA
BLAS	ATCAGCCTCGACTGTGCCTTCTAGTTGCCAGCCATCGAGACTATACAAGGATCTACCTCAGTCGCATATTTATTTATTTATTTGTTTGTTTGTTTTATTCACAAGCAGAGGCTCTGGCAGCTTTTGCCAACA
BLAp	ATCAGCCTCGACTGTGCCTTCTAGTTGCCAGCCATCGAGACTATACAAGGATCTACCTCAGTCGCATATTTATTTATTTATTTGTTTGTTTGTTTTATTGTCAGCTCCGACTTGTAAATATCAGCCTCGACT
BLBA	ATCAGCCTCGACTGTGCCTTCTAGTTGCCAGCCATCGAGACTATACAAGGATCTACCTCAGTCGCAATCAGCCTCGACTGTGCCTTCTAGTTGCCAGCCTATTTATTTATTTATTTGTTTGTTTGTTTTATT
BLBB	ATCAGCCTCGACTGTGCCTTCTAGTTGCCAGCCATCGAGACTATACAAGGATCTACCTCAGTCGCAATCAGCCTCGACTGTGCCTTCTAGTTGCCAGCCATCAGCCTCGACTGTGCCTTCTAGTTGCCAGCC
BLBL	ATCAGCCTCGACTGTGCCTTCTAGTTGCCAGCCATCGAGACTATACAAGGATCTACCTCAGTCGCAATCAGCCTCGACTGTGCCTTCTAGTTGCCAGCCATCGAGACTATACAAGGATCTACCTCAGTCGCA
BLBS	ATCAGCCTCGACTGTGCCTTCTAGTTGCCAGCCATCGAGACTATACAAGGATCTACCTCAGTCGCAATCAGCCTCGACTGTGCCTTCTAGTTGCCAGCCCACAAGCAGAGGCTCTGGCAGCTTTTGCCAACA
BLBp	ATCAGCCTCGACTGTGCCTTCTAGTTGCCAGCCATCGAGACTATACAAGGATCTACCTCAGTCGCAATCAGCCTCGACTGTGCCTTCTAGTTGCCAGCCGTCAGCTCCGACTTGTAAATATCAGCCTCGACT
BLLA	ATCAGCCTCGACTGTGCCTTCTAGTTGCCAGCCATCGAGACTATACAAGGATCTACCTCAGTCGCAATCGAGACTATACAAGGATCTACCTCAGTCGCATATTTATTTATTTATTTGTTTGTTTGTTTTATT
BLLB	ATCAGCCTCGACTGTGCCTTCTAGTTGCCAGCCATCGAGACTATACAAGGATCTACCTCAGTCGCAATCGAGACTATACAAGGATCTACCTCAGTCGCAATCAGCCTCGACTGTGCCTTCTAGTTGCCAGCC
BLLL	ATCAGCCTCGACTGTGCCTTCTAGTTGCCAGCCATCGAGACTATACAAGGATCTACCTCAGTCGCAATCGAGACTATACAAGGATCTACCTCAGTCGCAATCGAGACTATACAAGGATCTACCTCAGTCGCA
BLLS	ATCAGCCTCGACTGTGCCTTCTAGTTGCCAGCCATCGAGACTATACAAGGATCTACCTCAGTCGCAATCGAGACTATACAAGGATCTACCTCAGTCGCACACAAGCAGAGGCTCTGGCAGCTTTTGCCAACA
BLLp	ATCAGCCTCGACTGTGCCTTCTAGTTGCCAGCCATCGAGACTATACAAGGATCTACCTCAGTCGCAATCGAGACTATACAAGGATCTACCTCAGTCGCAGTCAGCTCCGACTTGTAAATATCAGCCTCGACT
BLSA	ATCAGCCTCGACTGTGCCTTCTAGTTGCCAGCCATCGAGACTATACAAGGATCTACCTCAGTCGCACACAAGCAGAGGCTCTGGCAGCTTTTGCCAACATATTTATTTATTTATTTGTTTGTTTGTTTTATT
BLSB	ATCAGCCTCGACTGTGCCTTCTAGTTGCCAGCCATCGAGACTATACAAGGATCTACCTCAGTCGCACACAAGCAGAGGCTCTGGCAGCTTTTGCCAACAATCAGCCTCGACTGTGCCTTCTAGTTGCCAGCC
BLSL	ATCAGCCTCGACTGTGCCTTCTAGTTGCCAGCCATCGAGACTATACAAGGATCTACCTCAGTCGCACACAAGCAGAGGCTCTGGCAGCTTTTGCCAACAATCGAGACTATACAAGGATCTACCTCAGTCGCA
BLSS	ATCAGCCTCGACTGTGCCTTCTAGTTGCCAGCCATCGAGACTATACAAGGATCTACCTCAGTCGCACACAAGCAGAGGCTCTGGCAGCTTTTGCCAACACACAAGCAGAGGCTCTGGCAGCTTTTGCCAACA
BLSp	ATCAGCCTCGACTGTGCCTTCTAGTTGCCAGCCATCGAGACTATACAAGGATCTACCTCAGTCGCACACAAGCAGAGGCTCTGGCAGCTTTTGCCAACAGTCAGCTCCGACTTGTAAATATCAGCCTCGACT
BLpA	ATCAGCCTCGACTGTGCCTTCTAGTTGCCAGCCATCGAGACTATACAAGGATCTACCTCAGTCGCAGTCAGCTCCGACTTGTAAATATCAGCCTCGACTTATTTATTTATTTATTTGTTTGTTTGTTTTATT
BLpB	ATCAGCCTCGACTGTGCCTTCTAGTTGCCAGCCATCGAGACTATACAAGGATCTACCTCAGTCGCAGTCAGCTCCGACTTGTAAATATCAGCCTCGACTATCAGCCTCGACTGTGCCTTCTAGTTGCCAGCC
BLpL	ATCAGCCTCGACTGTGCCTTCTAGTTGCCAGCCATCGAGACTATACAAGGATCTACCTCAGTCGCAGTCAGCTCCGACTTGTAAATATCAGCCTCGACTATCGAGACTATACAAGGATCTACCTCAGTCGCA
BLpS	ATCAGCCTCGACTGTGCCTTCTAGTTGCCAGCCATCGAGACTATACAAGGATCTACCTCAGTCGCAGTCAGCTCCGACTTGTAAATATCAGCCTCGACTCACAAGCAGAGGCTCTGGCAGCTTTTGCCAACA
BLpp	ATCAGCCTCGACTGTGCCTTCTAGTTGCCAGCCATCGAGACTATACAAGGATCTACCTCAGTCGCAGTCAGCTCCGACTTGTAAATATCAGCCTCGACTGTCAGCTCCGACTTGTAAATATCAGCCTCGACT
BSAA	ATCAGCCTCGACTGTGCCTTCTAGTTGCCAGCCCACAAGCAGAGGCTCTGGCAGCTTTTGCCAACATATTTATTTATTTATTTGTTTGTTTGTTTTATTTATTTATTTATTTATTTGTTTGTTTGTTTTATT
BSAB	ATCAGCCTCGACTGTGCCTTCTAGTTGCCAGCCCACAAGCAGAGGCTCTGGCAGCTTTTGCCAACATATTTATTTATTTATTTGTTTGTTTGTTTTATTATCAGCCTCGACTGTGCCTTCTAGTTGCCAGCC
BSAL	ATCAGCCTCGACTGTGCCTTCTAGTTGCCAGCCCACAAGCAGAGGCTCTGGCAGCTTTTGCCAACATATTTATTTATTTATTTGTTTGTTTGTTTTATTATCGAGACTATACAAGGATCTACCTCAGTCGCA
BSAS	ATCAGCCTCGACTGTGCCTTCTAGTTGCCAGCCCACAAGCAGAGGCTCTGGCAGCTTTTGCCAACATATTTATTTATTTATTTGTTTGTTTGTTTTATTCACAAGCAGAGGCTCTGGCAGCTTTTGCCAACA
BSAp	ATCAGCCTCGACTGTGCCTTCTAGTTGCCAGCCCACAAGCAGAGGCTCTGGCAGCTTTTGCCAACATATTTATTTATTTATTTGTTTGTTTGTTTTATTGTCAGCTCCGACTTGTAAATATCAGCCTCGACT
BSBA	ATCAGCCTCGACTGTGCCTTCTAGTTGCCAGCCCACAAGCAGAGGCTCTGGCAGCTTTTGCCAACAATCAGCCTCGACTGTGCCTTCTAGTTGCCAGCCTATTTATTTATTTATTTGTTTGTTTGTTTTATT
BSBB	ATCAGCCTCGACTGTGCCTTCTAGTTGCCAGCCCACAAGCAGAGGCTCTGGCAGCTTTTGCCAACAATCAGCCTCGACTGTGCCTTCTAGTTGCCAGCCATCAGCCTCGACTGTGCCTTCTAGTTGCCAGCC
BSBL	ATCAGCCTCGACTGTGCCTTCTAGTTGCCAGCCCACAAGCAGAGGCTCTGGCAGCTTTTGCCAACAATCAGCCTCGACTGTGCCTTCTAGTTGCCAGCCATCGAGACTATACAAGGATCTACCTCAGTCGCA
BSBS	ATCAGCCTCGACTGTGCCTTCTAGTTGCCAGCCCACAAGCAGAGGCTCTGGCAGCTTTTGCCAACAATCAGCCTCGACTGTGCCTTCTAGTTGCCAGCCCACAAGCAGAGGCTCTGGCAGCTTTTGCCAACA
BSBp	ATCAGCCTCGACTGTGCCTTCTAGTTGCCAGCCCACAAGCAGAGGCTCTGGCAGCTTTTGCCAACAATCAGCCTCGACTGTGCCTTCTAGTTGCCAGCCGTCAGCTCCGACTTGTAAATATCAGCCTCGACT
BSLA	ATCAGCCTCGACTGTGCCTTCTAGTTGCCAGCCCACAAGCAGAGGCTCTGGCAGCTTTTGCCAACAATCGAGACTATACAAGGATCTACCTCAGTCGCATATTTATTTATTTATTTGTTTGTTTGTTTTATT
BSLB	ATCAGCCTCGACTGTGCCTTCTAGTTGCCAGCCCACAAGCAGAGGCTCTGGCAGCTTTTGCCAACAATCGAGACTATACAAGGATCTACCTCAGTCGCAATCAGCCTCGACTGTGCCTTCTAGTTGCCAGCC
BSLL	ATCAGCCTCGACTGTGCCTTCTAGTTGCCAGCCCACAAGCAGAGGCTCTGGCAGCTTTTGCCAACAATCGAGACTATACAAGGATCTACCTCAGTCGCAATCGAGACTATACAAGGATCTACCTCAGTCGCA
BSLS	ATCAGCCTCGACTGTGCCTTCTAGTTGCCAGCCCACAAGCAGAGGCTCTGGCAGCTTTTGCCAACAATCGAGACTATACAAGGATCTACCTCAGTCGCACACAAGCAGAGGCTCTGGCAGCTTTTGCCAACA
BSLp	ATCAGCCTCGACTGTGCCTTCTAGTTGCCAGCCCACAAGCAGAGGCTCTGGCAGCTTTTGCCAACAATCGAGACTATACAAGGATCTACCTCAGTCGCAGTCAGCTCCGACTTGTAAATATCAGCCTCGACT
BSSA	ATCAGCCTCGACTGTGCCTTCTAGTTGCCAGCCCACAAGCAGAGGCTCTGGCAGCTTTTGCCAACACACAAGCAGAGGCTCTGGCAGCTTTTGCCAACATATTTATTTATTTATTTGTTTGTTTGTTTTATT
BSSB	ATCAGCCTCGACTGTGCCTTCTAGTTGCCAGCCCACAAGCAGAGGCTCTGGCAGCTTTTGCCAACACACAAGCAGAGGCTCTGGCAGCTTTTGCCAACAATCAGCCTCGACTGTGCCTTCTAGTTGCCAGCC
BSSL	ATCAGCCTCGACTGTGCCTTCTAGTTGCCAGCCCACAAGCAGAGGCTCTGGCAGCTTTTGCCAACACACAAGCAGAGGCTCTGGCAGCTTTTGCCAACAATCGAGACTATACAAGGATCTACCTCAGTCGCA
BSSS	ATCAGCCTCGACTGTGCCTTCTAGTTGCCAGCCCACAAGCAGAGGCTCTGGCAGCTTTTGCCAACACACAAGCAGAGGCTCTGGCAGCTTTTGCCAACACACAAGCAGAGGCTCTGGCAGCTTTTGCCAACA
BSSp	ATCAGCCTCGACTGTGCCTTCTAGTTGCCAGCCCACAAGCAGAGGCTCTGGCAGCTTTTGCCAACACACAAGCAGAGGCTCTGGCAGCTTTTGCCAACAGTCAGCTCCGACTTGTAAATATCAGCCTCGACT
BSpA	ATCAGCCTCGACTGTGCCTTCTAGTTGCCAGCCCACAAGCAGAGGCTCTGGCAGCTTTTGCCAACAGTCAGCTCCGACTTGTAAATATCAGCCTCGACTTATTTATTTATTTATTTGTTTGTTTGTTTTATT
BSpB	ATCAGCCTCGACTGTGCCTTCTAGTTGCCAGCCCACAAGCAGAGGCTCTGGCAGCTTTTGCCAACAGTCAGCTCCGACTTGTAAATATCAGCCTCGACTATCAGCCTCGACTGTGCCTTCTAGTTGCCAGCC
BSpL	ATCAGCCTCGACTGTGCCTTCTAGTTGCCAGCCCACAAGCAGAGGCTCTGGCAGCTTTTGCCAACAGTCAGCTCCGACTTGTAAATATCAGCCTCGACTATCGAGACTATACAAGGATCTACCTCAGTCGCA
BSpS	ATCAGCCTCGACTGTGCCTTCTAGTTGCCAGCCCACAAGCAGAGGCTCTGGCAGCTTTTGCCAACAGTCAGCTCCGACTTGTAAATATCAGCCTCGACTCACAAGCAGAGGCTCTGGCAGCTTTTGCCAACA
BSpp	ATCAGCCTCGACTGTGCCTTCTAGTTGCCAGCCCACAAGCAGAGGCTCTGGCAGCTTTTGCCAACAGTCAGCTCCGACTTGTAAATATCAGCCTCGACTGTCAGCTCCGACTTGTAAATATCAGCCTCGACT
BpAA	ATCAGCCTCGACTGTGCCTTCTAGTTGCCAGCCGTCAGCTCCGACTTGTAAATATCAGCCTCGACTTATTTATTTATTTATTTGTTTGTTTGTTTTATTTATTTATTTATTTATTTGTTTGTTTGTTTTATT
BpAB	ATCAGCCTCGACTGTGCCTTCTAGTTGCCAGCCGTCAGCTCCGACTTGTAAATATCAGCCTCGACTTATTTATTTATTTATTTGTTTGTTTGTTTTATTATCAGCCTCGACTGTGCCTTCTAGTTGCCAGCC
BpAL	ATCAGCCTCGACTGTGCCTTCTAGTTGCCAGCCGTCAGCTCCGACTTGTAAATATCAGCCTCGACTTATTTATTTATTTATTTGTTTGTTTGTTTTATTATCGAGACTATACAAGGATCTACCTCAGTCGCA
BpAS	ATCAGCCTCGACTGTGCCTTCTAGTTGCCAGCCGTCAGCTCCGACTTGTAAATATCAGCCTCGACTTATTTATTTATTTATTTGTTTGTTTGTTTTATTCACAAGCAGAGGCTCTGGCAGCTTTTGCCAACA
BpAp	ATCAGCCTCGACTGTGCCTTCTAGTTGCCAGCCGTCAGCTCCGACTTGTAAATATCAGCCTCGACTTATTTATTTATTTATTTGTTTGTTTGTTTTATTGTCAGCTCCGACTTGTAAATATCAGCCTCGACT
BpBA	ATCAGCCTCGACTGTGCCTTCTAGTTGCCAGCCGTCAGCTCCGACTTGTAAATATCAGCCTCGACTATCAGCCTCGACTGTGCCTTCTAGTTGCCAGCCTATTTATTTATTTATTTGTTTGTTTGTTTTATT
BpBB	ATCAGCCTCGACTGTGCCTTCTAGTTGCCAGCCGTCAGCTCCGACTTGTAAATATCAGCCTCGACTATCAGCCTCGACTGTGCCTTCTAGTTGCCAGCCATCAGCCTCGACTGTGCCTTCTAGTTGCCAGCC
BpBL	ATCAGCCTCGACTGTGCCTTCTAGTTGCCAGCCGTCAGCTCCGACTTGTAAATATCAGCCTCGACTATCAGCCTCGACTGTGCCTTCTAGTTGCCAGCCATCGAGACTATACAAGGATCTACCTCAGTCGCA
BpBS	ATCAGCCTCGACTGTGCCTTCTAGTTGCCAGCCGTCAGCTCCGACTTGTAAATATCAGCCTCGACTATCAGCCTCGACTGTGCCTTCTAGTTGCCAGCCCACAAGCAGAGGCTCTGGCAGCTTTTGCCAACA
BpBp	ATCAGCCTCGACTGTGCCTTCTAGTTGCCAGCCGTCAGCTCCGACTTGTAAATATCAGCCTCGACTATCAGCCTCGACTGTGCCTTCTAGTTGCCAGCCGTCAGCTCCGACTTGTAAATATCAGCCTCGACT
BpLA	ATCAGCCTCGACTGTGCCTTCTAGTTGCCAGCCGTCAGCTCCGACTTGTAAATATCAGCCTCGACTATCGAGACTATACAAGGATCTACCTCAGTCGCATATTTATTTATTTATTTGTTTGTTTGTTTTATT
BpLB	ATCAGCCTCGACTGTGCCTTCTAGTTGCCAGCCGTCAGCTCCGACTTGTAAATATCAGCCTCGACTATCGAGACTATACAAGGATCTACCTCAGTCGCAATCAGCCTCGACTGTGCCTTCTAGTTGCCAGCC
BpLL	ATCAGCCTCGACTGTGCCTTCTAGTTGCCAGCCGTCAGCTCCGACTTGTAAATATCAGCCTCGACTATCGAGACTATACAAGGATCTACCTCAGTCGCAATCGAGACTATACAAGGATCTACCTCAGTCGCA
BpLS	ATCAGCCTCGACTGTGCCTTCTAGTTGCCAGCCGTCAGCTCCGACTTGTAAATATCAGCCTCGACTATCGAGACTATACAAGGATCTACCTCAGTCGCACACAAGCAGAGGCTCTGGCAGCTTTTGCCAACA
BpLp	ATCAGCCTCGACTGTGCCTTCTAGTTGCCAGCCGTCAGCTCCGACTTGTAAATATCAGCCTCGACTATCGAGACTATACAAGGATCTACCTCAGTCGCAGTCAGCTCCGACTTGTAAATATCAGCCTCGACT
BpSA	ATCAGCCTCGACTGTGCCTTCTAGTTGCCAGCCGTCAGCTCCGACTTGTAAATATCAGCCTCGACTCACAAGCAGAGGCTCTGGCAGCTTTTGCCAACATATTTATTTATTTATTTGTTTGTTTGTTTTATT
BpSB	ATCAGCCTCGACTGTGCCTTCTAGTTGCCAGCCGTCAGCTCCGACTTGTAAATATCAGCCTCGACTCACAAGCAGAGGCTCTGGCAGCTTTTGCCAACAATCAGCCTCGACTGTGCCTTCTAGTTGCCAGCC
BpSL	ATCAGCCTCGACTGTGCCTTCTAGTTGCCAGCCGTCAGCTCCGACTTGTAAATATCAGCCTCGACTCACAAGCAGAGGCTCTGGCAGCTTTTGCCAACAATCGAGACTATACAAGGATCTACCTCAGTCGCA
BpSS	ATCAGCCTCGACTGTGCCTTCTAGTTGCCAGCCGTCAGCTCCGACTTGTAAATATCAGCCTCGACTCACAAGCAGAGGCTCTGGCAGCTTTTGCCAACACACAAGCAGAGGCTCTGGCAGCTTTTGCCAACA
BpSp	ATCAGCCTCGACTGTGCCTTCTAGTTGCCAGCCGTCAGCTCCGACTTGTAAATATCAGCCTCGACTCACAAGCAGAGGCTCTGGCAGCTTTTGCCAACAGTCAGCTCCGACTTGTAAATATCAGCCTCGACT
BppA	ATCAGCCTCGACTGTGCCTTCTAGTTGCCAGCCGTCAGCTCCGACTTGTAAATATCAGCCTCGACTGTCAGCTCCGACTTGTAAATATCAGCCTCGACTTATTTATTTATTTATTTGTTTGTTTGTTTTATT
BppB	ATCAGCCTCGACTGTGCCTTCTAGTTGCCAGCCGTCAGCTCCGACTTGTAAATATCAGCCTCGACTGTCAGCTCCGACTTGTAAATATCAGCCTCGACTATCAGCCTCGACTGTGCCTTCTAGTTGCCAGCC
BppL	ATCAGCCTCGACTGTGCCTTCTAGTTGCCAGCCGTCAGCTCCGACTTGTAAATATCAGCCTCGACTGTCAGCTCCGACTTGTAAATATCAGCCTCGACTATCGAGACTATACAAGGATCTACCTCAGTCGCA
BppS	ATCAGCCTCGACTGTGCCTTCTAGTTGCCAGCCGTCAGCTCCGACTTGTAAATATCAGCCTCGACTGTCAGCTCCGACTTGTAAATATCAGCCTCGACTCACAAGCAGAGGCTCTGGCAGCTTTTGCCAACA
Bppp	ATCAGCCTCGACTGTGCCTTCTAGTTGCCAGCCGTCAGCTCCGACTTGTAAATATCAGCCTCGACTGTCAGCTCCGACTTGTAAATATCAGCCTCGACTGTCAGCTCCGACTTGTAAATATCAGCCTCGACT
LAAA	ATCGAGACTATACAAGGATCTACCTCAGTCGCATATTTATTTATTTATTTGTTTGTTTGTTTTATTTATTTATTTATTTATTTGTTTGTTTGTTTTATTTATTTATTTATTTATTTGTTTGTTTGTTTTATT
LAAB	ATCGAGACTATACAAGGATCTACCTCAGTCGCATATTTATTTATTTATTTGTTTGTTTGTTTTATTTATTTATTTATTTATTTGTTTGTTTGTTTTATTATCAGCCTCGACTGTGCCTTCTAGTTGCCAGCC
Dna2	ATCGATAAAATTTTTATTTCTACCTCAGTCGCAATCGATAAAATTTTTATTTCTACCTCAGTCGCAATCGATAAAATTTTTATTTCTACCTCAGTCGCAATCGATAAAATTTTTATTTCTACCTCAGTCGCA
LAAL	ATCGAGACTATACAAGGATCTACCTCAGTCGCATATTTATTTATTTATTTGTTTGTTTGTTTTATTTATTTATTTATTTATTTGTTTGTTTGTTTTATTATCGAGACTATACAAGGATCTACCTCAGTCGCA
FIGNL2	ATCGACGCTGTAACCATTTCTACCTCAGTCGCAATCGACGCTGTAACCATTTCTACCTCAGTCGCAATCGACGCTGTAACCATTTCTACCTCAGTCGCAATCGACGCTGTAACCATTTCTACCTCAGTCGCA
LAAS	ATCGAGACTATACAAGGATCTACCTCAGTCGCATATTTATTTATTTATTTGTTTGTTTGTTTTATTTATTTATTTATTTATTTGTTTGTTTGTTTTATTCACAAGCAGAGGCTCTGGCAGCTTTTGCCAACA
HMGA2	ATCGAATCAAAACACACTACTACCTCTGTCGCAATCGAATCAAAACACACTACTACCTCTGTCGCAATCGAATCAAAACACACTACTACCTCTGTCGCAATCGAATCAAAACACACTACTACCTCTGTCGCA
LAAp	ATCGAGACTATACAAGGATCTACCTCAGTCGCATATTTATTTATTTATTTGTTTGTTTGTTTTATTTATTTATTTATTTATTTGTTTGTTTGTTTTATTGTCAGCTCCGACTTGTAAATATCAGCCTCGACT
LABA	ATCGAGACTATACAAGGATCTACCTCAGTCGCATATTTATTTATTTATTTGTTTGTTTGTTTTATTATCAGCCTCGACTGTGCCTTCTAGTTGCCAGCCTATTTATTTATTTATTTGTTTGTTTGTTTTATT
LABB	ATCGAGACTATACAAGGATCTACCTCAGTCGCATATTTATTTATTTATTTGTTTGTTTGTTTTATTATCAGCCTCGACTGTGCCTTCTAGTTGCCAGCCATCAGCCTCGACTGTGCCTTCTAGTTGCCAGCC
LABL	ATCGAGACTATACAAGGATCTACCTCAGTCGCATATTTATTTATTTATTTGTTTGTTTGTTTTATTATCAGCCTCGACTGTGCCTTCTAGTTGCCAGCCATCGAGACTATACAAGGATCTACCTCAGTCGCA
LABS	ATCGAGACTATACAAGGATCTACCTCAGTCGCATATTTATTTATTTATTTGTTTGTTTGTTTTATTATCAGCCTCGACTGTGCCTTCTAGTTGCCAGCCCACAAGCAGAGGCTCTGGCAGCTTTTGCCAACA
LABp	ATCGAGACTATACAAGGATCTACCTCAGTCGCATATTTATTTATTTATTTGTTTGTTTGTTTTATTATCAGCCTCGACTGTGCCTTCTAGTTGCCAGCCGTCAGCTCCGACTTGTAAATATCAGCCTCGACT
LALA	ATCGAGACTATACAAGGATCTACCTCAGTCGCATATTTATTTATTTATTTGTTTGTTTGTTTTATTATCGAGACTATACAAGGATCTACCTCAGTCGCATATTTATTTATTTATTTGTTTGTTTGTTTTATT
LALB	ATCGAGACTATACAAGGATCTACCTCAGTCGCATATTTATTTATTTATTTGTTTGTTTGTTTTATTATCGAGACTATACAAGGATCTACCTCAGTCGCAATCAGCCTCGACTGTGCCTTCTAGTTGCCAGCC
LALL	ATCGAGACTATACAAGGATCTACCTCAGTCGCATATTTATTTATTTATTTGTTTGTTTGTTTTATTATCGAGACTATACAAGGATCTACCTCAGTCGCAATCGAGACTATACAAGGATCTACCTCAGTCGCA
LALS	ATCGAGACTATACAAGGATCTACCTCAGTCGCATATTTATTTATTTATTTGTTTGTTTGTTTTATTATCGAGACTATACAAGGATCTACCTCAGTCGCACACAAGCAGAGGCTCTGGCAGCTTTTGCCAACA
LALp	ATCGAGACTATACAAGGATCTACCTCAGTCGCATATTTATTTATTTATTTGTTTGTTTGTTTTATTATCGAGACTATACAAGGATCTACCTCAGTCGCAGTCAGCTCCGACTTGTAAATATCAGCCTCGACT
LASA	ATCGAGACTATACAAGGATCTACCTCAGTCGCATATTTATTTATTTATTTGTTTGTTTGTTTTATTCACAAGCAGAGGCTCTGGCAGCTTTTGCCAACATATTTATTTATTTATTTGTTTGTTTGTTTTATT
LASB	ATCGAGACTATACAAGGATCTACCTCAGTCGCATATTTATTTATTTATTTGTTTGTTTGTTTTATTCACAAGCAGAGGCTCTGGCAGCTTTTGCCAACAATCAGCCTCGACTGTGCCTTCTAGTTGCCAGCC
LASL	ATCGAGACTATACAAGGATCTACCTCAGTCGCATATTTATTTATTTATTTGTTTGTTTGTTTTATTCACAAGCAGAGGCTCTGGCAGCTTTTGCCAACAATCGAGACTATACAAGGATCTACCTCAGTCGCA
LASS	ATCGAGACTATACAAGGATCTACCTCAGTCGCATATTTATTTATTTATTTGTTTGTTTGTTTTATTCACAAGCAGAGGCTCTGGCAGCTTTTGCCAACACACAAGCAGAGGCTCTGGCAGCTTTTGCCAACA
LASp	ATCGAGACTATACAAGGATCTACCTCAGTCGCATATTTATTTATTTATTTGTTTGTTTGTTTTATTCACAAGCAGAGGCTCTGGCAGCTTTTGCCAACAGTCAGCTCCGACTTGTAAATATCAGCCTCGACT
LApA	ATCGAGACTATACAAGGATCTACCTCAGTCGCATATTTATTTATTTATTTGTTTGTTTGTTTTATTGTCAGCTCCGACTTGTAAATATCAGCCTCGACTTATTTATTTATTTATTTGTTTGTTTGTTTTATT
LApB	ATCGAGACTATACAAGGATCTACCTCAGTCGCATATTTATTTATTTATTTGTTTGTTTGTTTTATTGTCAGCTCCGACTTGTAAATATCAGCCTCGACTATCAGCCTCGACTGTGCCTTCTAGTTGCCAGCC
LApL	ATCGAGACTATACAAGGATCTACCTCAGTCGCATATTTATTTATTTATTTGTTTGTTTGTTTTATTGTCAGCTCCGACTTGTAAATATCAGCCTCGACTATCGAGACTATACAAGGATCTACCTCAGTCGCA
LApS	ATCGAGACTATACAAGGATCTACCTCAGTCGCATATTTATTTATTTATTTGTTTGTTTGTTTTATTGTCAGCTCCGACTTGTAAATATCAGCCTCGACTCACAAGCAGAGGCTCTGGCAGCTTTTGCCAACA
LApp	ATCGAGACTATACAAGGATCTACCTCAGTCGCATATTTATTTATTTATTTGTTTGTTTGTTTTATTGTCAGCTCCGACTTGTAAATATCAGCCTCGACTGTCAGCTCCGACTTGTAAATATCAGCCTCGACT
LBAA	ATCGAGACTATACAAGGATCTACCTCAGTCGCAATCAGCCTCGACTGTGCCTTCTAGTTGCCAGCCTATTTATTTATTTATTTGTTTGTTTGTTTTATTTATTTATTTATTTATTTGTTTGTTTGTTTTATT
LBAB	ATCGAGACTATACAAGGATCTACCTCAGTCGCAATCAGCCTCGACTGTGCCTTCTAGTTGCCAGCCTATTTATTTATTTATTTGTTTGTTTGTTTTATTATCAGCCTCGACTGTGCCTTCTAGTTGCCAGCC
LBAL	ATCGAGACTATACAAGGATCTACCTCAGTCGCAATCAGCCTCGACTGTGCCTTCTAGTTGCCAGCCTATTTATTTATTTATTTGTTTGTTTGTTTTATTATCGAGACTATACAAGGATCTACCTCAGTCGCA
LBAS	ATCGAGACTATACAAGGATCTACCTCAGTCGCAATCAGCCTCGACTGTGCCTTCTAGTTGCCAGCCTATTTATTTATTTATTTGTTTGTTTGTTTTATTCACAAGCAGAGGCTCTGGCAGCTTTTGCCAACA
LBAp	ATCGAGACTATACAAGGATCTACCTCAGTCGCAATCAGCCTCGACTGTGCCTTCTAGTTGCCAGCCTATTTATTTATTTATTTGTTTGTTTGTTTTATTGTCAGCTCCGACTTGTAAATATCAGCCTCGACT
LBBA	ATCGAGACTATACAAGGATCTACCTCAGTCGCAATCAGCCTCGACTGTGCCTTCTAGTTGCCAGCCATCAGCCTCGACTGTGCCTTCTAGTTGCCAGCCTATTTATTTATTTATTTGTTTGTTTGTTTTATT
LBBB	ATCGAGACTATACAAGGATCTACCTCAGTCGCAATCAGCCTCGACTGTGCCTTCTAGTTGCCAGCCATCAGCCTCGACTGTGCCTTCTAGTTGCCAGCCATCAGCCTCGACTGTGCCTTCTAGTTGCCAGCC
LBBL	ATCGAGACTATACAAGGATCTACCTCAGTCGCAATCAGCCTCGACTGTGCCTTCTAGTTGCCAGCCATCAGCCTCGACTGTGCCTTCTAGTTGCCAGCCATCGAGACTATACAAGGATCTACCTCAGTCGCA
LBBS	ATCGAGACTATACAAGGATCTACCTCAGTCGCAATCAGCCTCGACTGTGCCTTCTAGTTGCCAGCCATCAGCCTCGACTGTGCCTTCTAGTTGCCAGCCCACAAGCAGAGGCTCTGGCAGCTTTTGCCAACA
LBBp	ATCGAGACTATACAAGGATCTACCTCAGTCGCAATCAGCCTCGACTGTGCCTTCTAGTTGCCAGCCATCAGCCTCGACTGTGCCTTCTAGTTGCCAGCCGTCAGCTCCGACTTGTAAATATCAGCCTCGACT
LBLA	ATCGAGACTATACAAGGATCTACCTCAGTCGCAATCAGCCTCGACTGTGCCTTCTAGTTGCCAGCCATCGAGACTATACAAGGATCTACCTCAGTCGCATATTTATTTATTTATTTGTTTGTTTGTTTTATT
LBLB	ATCGAGACTATACAAGGATCTACCTCAGTCGCAATCAGCCTCGACTGTGCCTTCTAGTTGCCAGCCATCGAGACTATACAAGGATCTACCTCAGTCGCAATCAGCCTCGACTGTGCCTTCTAGTTGCCAGCC
LBLL	ATCGAGACTATACAAGGATCTACCTCAGTCGCAATCAGCCTCGACTGTGCCTTCTAGTTGCCAGCCATCGAGACTATACAAGGATCTACCTCAGTCGCAATCGAGACTATACAAGGATCTACCTCAGTCGCA
LBLS	ATCGAGACTATACAAGGATCTACCTCAGTCGCAATCAGCCTCGACTGTGCCTTCTAGTTGCCAGCCATCGAGACTATACAAGGATCTACCTCAGTCGCACACAAGCAGAGGCTCTGGCAGCTTTTGCCAACA
LBLp	ATCGAGACTATACAAGGATCTACCTCAGTCGCAATCAGCCTCGACTGTGCCTTCTAGTTGCCAGCCATCGAGACTATACAAGGATCTACCTCAGTCGCAGTCAGCTCCGACTTGTAAATATCAGCCTCGACT
LBSA	ATCGAGACTATACAAGGATCTACCTCAGTCGCAATCAGCCTCGACTGTGCCTTCTAGTTGCCAGCCCACAAGCAGAGGCTCTGGCAGCTTTTGCCAACATATTTATTTATTTATTTGTTTGTTTGTTTTATT
LBSB	ATCGAGACTATACAAGGATCTACCTCAGTCGCAATCAGCCTCGACTGTGCCTTCTAGTTGCCAGCCCACAAGCAGAGGCTCTGGCAGCTTTTGCCAACAATCAGCCTCGACTGTGCCTTCTAGTTGCCAGCC
LBSL	ATCGAGACTATACAAGGATCTACCTCAGTCGCAATCAGCCTCGACTGTGCCTTCTAGTTGCCAGCCCACAAGCAGAGGCTCTGGCAGCTTTTGCCAACAATCGAGACTATACAAGGATCTACCTCAGTCGCA
LBSS	ATCGAGACTATACAAGGATCTACCTCAGTCGCAATCAGCCTCGACTGTGCCTTCTAGTTGCCAGCCCACAAGCAGAGGCTCTGGCAGCTTTTGCCAACACACAAGCAGAGGCTCTGGCAGCTTTTGCCAACA
LBSp	ATCGAGACTATACAAGGATCTACCTCAGTCGCAATCAGCCTCGACTGTGCCTTCTAGTTGCCAGCCCACAAGCAGAGGCTCTGGCAGCTTTTGCCAACAGTCAGCTCCGACTTGTAAATATCAGCCTCGACT
LBpA	ATCGAGACTATACAAGGATCTACCTCAGTCGCAATCAGCCTCGACTGTGCCTTCTAGTTGCCAGCCGTCAGCTCCGACTTGTAAATATCAGCCTCGACTTATTTATTTATTTATTTGTTTGTTTGTTTTATT
LBpB	ATCGAGACTATACAAGGATCTACCTCAGTCGCAATCAGCCTCGACTGTGCCTTCTAGTTGCCAGCCGTCAGCTCCGACTTGTAAATATCAGCCTCGACTATCAGCCTCGACTGTGCCTTCTAGTTGCCAGCC
LBpL	ATCGAGACTATACAAGGATCTACCTCAGTCGCAATCAGCCTCGACTGTGCCTTCTAGTTGCCAGCCGTCAGCTCCGACTTGTAAATATCAGCCTCGACTATCGAGACTATACAAGGATCTACCTCAGTCGCA
LBpS	ATCGAGACTATACAAGGATCTACCTCAGTCGCAATCAGCCTCGACTGTGCCTTCTAGTTGCCAGCCGTCAGCTCCGACTTGTAAATATCAGCCTCGACTCACAAGCAGAGGCTCTGGCAGCTTTTGCCAACA
LBpp	ATCGAGACTATACAAGGATCTACCTCAGTCGCAATCAGCCTCGACTGTGCCTTCTAGTTGCCAGCCGTCAGCTCCGACTTGTAAATATCAGCCTCGACTGTCAGCTCCGACTTGTAAATATCAGCCTCGACT
LLAA	ATCGAGACTATACAAGGATCTACCTCAGTCGCAATCGAGACTATACAAGGATCTACCTCAGTCGCATATTTATTTATTTATTTGTTTGTTTGTTTTATTTATTTATTTATTTATTTGTTTGTTTGTTTTATT
LLAB	ATCGAGACTATACAAGGATCTACCTCAGTCGCAATCGAGACTATACAAGGATCTACCTCAGTCGCATATTTATTTATTTATTTGTTTGTTTGTTTTATTATCAGCCTCGACTGTGCCTTCTAGTTGCCAGCC
LLAL	ATCGAGACTATACAAGGATCTACCTCAGTCGCAATCGAGACTATACAAGGATCTACCTCAGTCGCATATTTATTTATTTATTTGTTTGTTTGTTTTATTATCGAGACTATACAAGGATCTACCTCAGTCGCA
LLAS	ATCGAGACTATACAAGGATCTACCTCAGTCGCAATCGAGACTATACAAGGATCTACCTCAGTCGCATATTTATTTATTTATTTGTTTGTTTGTTTTATTCACAAGCAGAGGCTCTGGCAGCTTTTGCCAACA
LLAp	ATCGAGACTATACAAGGATCTACCTCAGTCGCAATCGAGACTATACAAGGATCTACCTCAGTCGCATATTTATTTATTTATTTGTTTGTTTGTTTTATTGTCAGCTCCGACTTGTAAATATCAGCCTCGACT
LLBA	ATCGAGACTATACAAGGATCTACCTCAGTCGCAATCGAGACTATACAAGGATCTACCTCAGTCGCAATCAGCCTCGACTGTGCCTTCTAGTTGCCAGCCTATTTATTTATTTATTTGTTTGTTTGTTTTATT
LLBB	ATCGAGACTATACAAGGATCTACCTCAGTCGCAATCGAGACTATACAAGGATCTACCTCAGTCGCAATCAGCCTCGACTGTGCCTTCTAGTTGCCAGCCATCAGCCTCGACTGTGCCTTCTAGTTGCCAGCC
LLBL	ATCGAGACTATACAAGGATCTACCTCAGTCGCAATCGAGACTATACAAGGATCTACCTCAGTCGCAATCAGCCTCGACTGTGCCTTCTAGTTGCCAGCCATCGAGACTATACAAGGATCTACCTCAGTCGCA
LLBS	ATCGAGACTATACAAGGATCTACCTCAGTCGCAATCGAGACTATACAAGGATCTACCTCAGTCGCAATCAGCCTCGACTGTGCCTTCTAGTTGCCAGCCCACAAGCAGAGGCTCTGGCAGCTTTTGCCAACA
LLBp	ATCGAGACTATACAAGGATCTACCTCAGTCGCAATCGAGACTATACAAGGATCTACCTCAGTCGCAATCAGCCTCGACTGTGCCTTCTAGTTGCCAGCCGTCAGCTCCGACTTGTAAATATCAGCCTCGACT
LLLA	ATCGAGACTATACAAGGATCTACCTCAGTCGCAATCGAGACTATACAAGGATCTACCTCAGTCGCAATCGAGACTATACAAGGATCTACCTCAGTCGCATATTTATTTATTTATTTGTTTGTTTGTTTTATT
LLLB	ATCGAGACTATACAAGGATCTACCTCAGTCGCAATCGAGACTATACAAGGATCTACCTCAGTCGCAATCGAGACTATACAAGGATCTACCTCAGTCGCAATCAGCCTCGACTGTGCCTTCTAGTTGCCAGCC
LLLL	ATCGAGACTATACAAGGATCTACCTCAGTCGCAATCGAGACTATACAAGGATCTACCTCAGTCGCAATCGAGACTATACAAGGATCTACCTCAGTCGCAATCGAGACTATACAAGGATCTACCTCAGTCGCA
LLLS	ATCGAGACTATACAAGGATCTACCTCAGTCGCAATCGAGACTATACAAGGATCTACCTCAGTCGCAATCGAGACTATACAAGGATCTACCTCAGTCGCACACAAGCAGAGGCTCTGGCAGCTTTTGCCAACA
LLLp	ATCGAGACTATACAAGGATCTACCTCAGTCGCAATCGAGACTATACAAGGATCTACCTCAGTCGCAATCGAGACTATACAAGGATCTACCTCAGTCGCAGTCAGCTCCGACTTGTAAATATCAGCCTCGACT
LLSA	ATCGAGACTATACAAGGATCTACCTCAGTCGCAATCGAGACTATACAAGGATCTACCTCAGTCGCACACAAGCAGAGGCTCTGGCAGCTTTTGCCAACATATTTATTTATTTATTTGTTTGTTTGTTTTATT
LLSB	ATCGAGACTATACAAGGATCTACCTCAGTCGCAATCGAGACTATACAAGGATCTACCTCAGTCGCACACAAGCAGAGGCTCTGGCAGCTTTTGCCAACAATCAGCCTCGACTGTGCCTTCTAGTTGCCAGCC
LLSL	ATCGAGACTATACAAGGATCTACCTCAGTCGCAATCGAGACTATACAAGGATCTACCTCAGTCGCACACAAGCAGAGGCTCTGGCAGCTTTTGCCAACAATCGAGACTATACAAGGATCTACCTCAGTCGCA
LLSS	ATCGAGACTATACAAGGATCTACCTCAGTCGCAATCGAGACTATACAAGGATCTACCTCAGTCGCACACAAGCAGAGGCTCTGGCAGCTTTTGCCAACACACAAGCAGAGGCTCTGGCAGCTTTTGCCAACA
LLSp	ATCGAGACTATACAAGGATCTACCTCAGTCGCAATCGAGACTATACAAGGATCTACCTCAGTCGCACACAAGCAGAGGCTCTGGCAGCTTTTGCCAACAGTCAGCTCCGACTTGTAAATATCAGCCTCGACT
LLpA	ATCGAGACTATACAAGGATCTACCTCAGTCGCAATCGAGACTATACAAGGATCTACCTCAGTCGCAGTCAGCTCCGACTTGTAAATATCAGCCTCGACTTATTTATTTATTTATTTGTTTGTTTGTTTTATT
LLpB	ATCGAGACTATACAAGGATCTACCTCAGTCGCAATCGAGACTATACAAGGATCTACCTCAGTCGCAGTCAGCTCCGACTTGTAAATATCAGCCTCGACTATCAGCCTCGACTGTGCCTTCTAGTTGCCAGCC
LLpL	ATCGAGACTATACAAGGATCTACCTCAGTCGCAATCGAGACTATACAAGGATCTACCTCAGTCGCAGTCAGCTCCGACTTGTAAATATCAGCCTCGACTATCGAGACTATACAAGGATCTACCTCAGTCGCA
LLpS	ATCGAGACTATACAAGGATCTACCTCAGTCGCAATCGAGACTATACAAGGATCTACCTCAGTCGCAGTCAGCTCCGACTTGTAAATATCAGCCTCGACTCACAAGCAGAGGCTCTGGCAGCTTTTGCCAACA
LLpp	ATCGAGACTATACAAGGATCTACCTCAGTCGCAATCGAGACTATACAAGGATCTACCTCAGTCGCAGTCAGCTCCGACTTGTAAATATCAGCCTCGACTGTCAGCTCCGACTTGTAAATATCAGCCTCGACT
LSAA	ATCGAGACTATACAAGGATCTACCTCAGTCGCACACAAGCAGAGGCTCTGGCAGCTTTTGCCAACATATTTATTTATTTATTTGTTTGTTTGTTTTATTTATTTATTTATTTATTTGTTTGTTTGTTTTATT
LSAB	ATCGAGACTATACAAGGATCTACCTCAGTCGCACACAAGCAGAGGCTCTGGCAGCTTTTGCCAACATATTTATTTATTTATTTGTTTGTTTGTTTTATTATCAGCCTCGACTGTGCCTTCTAGTTGCCAGCC
LSAL	ATCGAGACTATACAAGGATCTACCTCAGTCGCACACAAGCAGAGGCTCTGGCAGCTTTTGCCAACATATTTATTTATTTATTTGTTTGTTTGTTTTATTATCGAGACTATACAAGGATCTACCTCAGTCGCA
LSAS	ATCGAGACTATACAAGGATCTACCTCAGTCGCACACAAGCAGAGGCTCTGGCAGCTTTTGCCAACATATTTATTTATTTATTTGTTTGTTTGTTTTATTCACAAGCAGAGGCTCTGGCAGCTTTTGCCAACA
LSAp	ATCGAGACTATACAAGGATCTACCTCAGTCGCACACAAGCAGAGGCTCTGGCAGCTTTTGCCAACATATTTATTTATTTATTTGTTTGTTTGTTTTATTGTCAGCTCCGACTTGTAAATATCAGCCTCGACT
LSBA	ATCGAGACTATACAAGGATCTACCTCAGTCGCACACAAGCAGAGGCTCTGGCAGCTTTTGCCAACAATCAGCCTCGACTGTGCCTTCTAGTTGCCAGCCTATTTATTTATTTATTTGTTTGTTTGTTTTATT
LSBB	ATCGAGACTATACAAGGATCTACCTCAGTCGCACACAAGCAGAGGCTCTGGCAGCTTTTGCCAACAATCAGCCTCGACTGTGCCTTCTAGTTGCCAGCCATCAGCCTCGACTGTGCCTTCTAGTTGCCAGCC
LSBL	ATCGAGACTATACAAGGATCTACCTCAGTCGCACACAAGCAGAGGCTCTGGCAGCTTTTGCCAACAATCAGCCTCGACTGTGCCTTCTAGTTGCCAGCCATCGAGACTATACAAGGATCTACCTCAGTCGCA
LSBS	ATCGAGACTATACAAGGATCTACCTCAGTCGCACACAAGCAGAGGCTCTGGCAGCTTTTGCCAACAATCAGCCTCGACTGTGCCTTCTAGTTGCCAGCCCACAAGCAGAGGCTCTGGCAGCTTTTGCCAACA
LSBp	ATCGAGACTATACAAGGATCTACCTCAGTCGCACACAAGCAGAGGCTCTGGCAGCTTTTGCCAACAATCAGCCTCGACTGTGCCTTCTAGTTGCCAGCCGTCAGCTCCGACTTGTAAATATCAGCCTCGACT
LSLA	ATCGAGACTATACAAGGATCTACCTCAGTCGCACACAAGCAGAGGCTCTGGCAGCTTTTGCCAACAATCGAGACTATACAAGGATCTACCTCAGTCGCATATTTATTTATTTATTTGTTTGTTTGTTTTATT
LSLB	ATCGAGACTATACAAGGATCTACCTCAGTCGCACACAAGCAGAGGCTCTGGCAGCTTTTGCCAACAATCGAGACTATACAAGGATCTACCTCAGTCGCAATCAGCCTCGACTGTGCCTTCTAGTTGCCAGCC
LSLL	ATCGAGACTATACAAGGATCTACCTCAGTCGCACACAAGCAGAGGCTCTGGCAGCTTTTGCCAACAATCGAGACTATACAAGGATCTACCTCAGTCGCAATCGAGACTATACAAGGATCTACCTCAGTCGCA
LSLS	ATCGAGACTATACAAGGATCTACCTCAGTCGCACACAAGCAGAGGCTCTGGCAGCTTTTGCCAACAATCGAGACTATACAAGGATCTACCTCAGTCGCACACAAGCAGAGGCTCTGGCAGCTTTTGCCAACA
LSLp	ATCGAGACTATACAAGGATCTACCTCAGTCGCACACAAGCAGAGGCTCTGGCAGCTTTTGCCAACAATCGAGACTATACAAGGATCTACCTCAGTCGCAGTCAGCTCCGACTTGTAAATATCAGCCTCGACT
LSSA	ATCGAGACTATACAAGGATCTACCTCAGTCGCACACAAGCAGAGGCTCTGGCAGCTTTTGCCAACACACAAGCAGAGGCTCTGGCAGCTTTTGCCAACATATTTATTTATTTATTTGTTTGTTTGTTTTATT
LSSB	ATCGAGACTATACAAGGATCTACCTCAGTCGCACACAAGCAGAGGCTCTGGCAGCTTTTGCCAACACACAAGCAGAGGCTCTGGCAGCTTTTGCCAACAATCAGCCTCGACTGTGCCTTCTAGTTGCCAGCC
LSSL	ATCGAGACTATACAAGGATCTACCTCAGTCGCACACAAGCAGAGGCTCTGGCAGCTTTTGCCAACACACAAGCAGAGGCTCTGGCAGCTTTTGCCAACAATCGAGACTATACAAGGATCTACCTCAGTCGCA
LSSS	ATCGAGACTATACAAGGATCTACCTCAGTCGCACACAAGCAGAGGCTCTGGCAGCTTTTGCCAACACACAAGCAGAGGCTCTGGCAGCTTTTGCCAACACACAAGCAGAGGCTCTGGCAGCTTTTGCCAACA
LSSp	ATCGAGACTATACAAGGATCTACCTCAGTCGCACACAAGCAGAGGCTCTGGCAGCTTTTGCCAACACACAAGCAGAGGCTCTGGCAGCTTTTGCCAACAGTCAGCTCCGACTTGTAAATATCAGCCTCGACT
LSpA	ATCGAGACTATACAAGGATCTACCTCAGTCGCACACAAGCAGAGGCTCTGGCAGCTTTTGCCAACAGTCAGCTCCGACTTGTAAATATCAGCCTCGACTTATTTATTTATTTATTTGTTTGTTTGTTTTATT
LSpB	ATCGAGACTATACAAGGATCTACCTCAGTCGCACACAAGCAGAGGCTCTGGCAGCTTTTGCCAACAGTCAGCTCCGACTTGTAAATATCAGCCTCGACTATCAGCCTCGACTGTGCCTTCTAGTTGCCAGCC
LSpL	ATCGAGACTATACAAGGATCTACCTCAGTCGCACACAAGCAGAGGCTCTGGCAGCTTTTGCCAACAGTCAGCTCCGACTTGTAAATATCAGCCTCGACTATCGAGACTATACAAGGATCTACCTCAGTCGCA
LSpS	ATCGAGACTATACAAGGATCTACCTCAGTCGCACACAAGCAGAGGCTCTGGCAGCTTTTGCCAACAGTCAGCTCCGACTTGTAAATATCAGCCTCGACTCACAAGCAGAGGCTCTGGCAGCTTTTGCCAACA
LSpp	ATCGAGACTATACAAGGATCTACCTCAGTCGCACACAAGCAGAGGCTCTGGCAGCTTTTGCCAACAGTCAGCTCCGACTTGTAAATATCAGCCTCGACTGTCAGCTCCGACTTGTAAATATCAGCCTCGACT
LpAA	ATCGAGACTATACAAGGATCTACCTCAGTCGCAGTCAGCTCCGACTTGTAAATATCAGCCTCGACTTATTTATTTATTTATTTGTTTGTTTGTTTTATTTATTTATTTATTTATTTGTTTGTTTGTTTTATT
LpAB	ATCGAGACTATACAAGGATCTACCTCAGTCGCAGTCAGCTCCGACTTGTAAATATCAGCCTCGACTTATTTATTTATTTATTTGTTTGTTTGTTTTATTATCAGCCTCGACTGTGCCTTCTAGTTGCCAGCC
LpAL	ATCGAGACTATACAAGGATCTACCTCAGTCGCAGTCAGCTCCGACTTGTAAATATCAGCCTCGACTTATTTATTTATTTATTTGTTTGTTTGTTTTATTATCGAGACTATACAAGGATCTACCTCAGTCGCA
LpAS	ATCGAGACTATACAAGGATCTACCTCAGTCGCAGTCAGCTCCGACTTGTAAATATCAGCCTCGACTTATTTATTTATTTATTTGTTTGTTTGTTTTATTCACAAGCAGAGGCTCTGGCAGCTTTTGCCAACA
LpAp	ATCGAGACTATACAAGGATCTACCTCAGTCGCAGTCAGCTCCGACTTGTAAATATCAGCCTCGACTTATTTATTTATTTATTTGTTTGTTTGTTTTATTGTCAGCTCCGACTTGTAAATATCAGCCTCGACT
LpBA	ATCGAGACTATACAAGGATCTACCTCAGTCGCAGTCAGCTCCGACTTGTAAATATCAGCCTCGACTATCAGCCTCGACTGTGCCTTCTAGTTGCCAGCCTATTTATTTATTTATTTGTTTGTTTGTTTTATT
LpBB	ATCGAGACTATACAAGGATCTACCTCAGTCGCAGTCAGCTCCGACTTGTAAATATCAGCCTCGACTATCAGCCTCGACTGTGCCTTCTAGTTGCCAGCCATCAGCCTCGACTGTGCCTTCTAGTTGCCAGCC
LpBL	ATCGAGACTATACAAGGATCTACCTCAGTCGCAGTCAGCTCCGACTTGTAAATATCAGCCTCGACTATCAGCCTCGACTGTGCCTTCTAGTTGCCAGCCATCGAGACTATACAAGGATCTACCTCAGTCGCA
LpBS	ATCGAGACTATACAAGGATCTACCTCAGTCGCAGTCAGCTCCGACTTGTAAATATCAGCCTCGACTATCAGCCTCGACTGTGCCTTCTAGTTGCCAGCCCACAAGCAGAGGCTCTGGCAGCTTTTGCCAACA
LpBp	ATCGAGACTATACAAGGATCTACCTCAGTCGCAGTCAGCTCCGACTTGTAAATATCAGCCTCGACTATCAGCCTCGACTGTGCCTTCTAGTTGCCAGCCGTCAGCTCCGACTTGTAAATATCAGCCTCGACT
LpLA	ATCGAGACTATACAAGGATCTACCTCAGTCGCAGTCAGCTCCGACTTGTAAATATCAGCCTCGACTATCGAGACTATACAAGGATCTACCTCAGTCGCATATTTATTTATTTATTTGTTTGTTTGTTTTATT
LpLB	ATCGAGACTATACAAGGATCTACCTCAGTCGCAGTCAGCTCCGACTTGTAAATATCAGCCTCGACTATCGAGACTATACAAGGATCTACCTCAGTCGCAATCAGCCTCGACTGTGCCTTCTAGTTGCCAGCC
LpLL	ATCGAGACTATACAAGGATCTACCTCAGTCGCAGTCAGCTCCGACTTGTAAATATCAGCCTCGACTATCGAGACTATACAAGGATCTACCTCAGTCGCAATCGAGACTATACAAGGATCTACCTCAGTCGCA
LpLS	ATCGAGACTATACAAGGATCTACCTCAGTCGCAGTCAGCTCCGACTTGTAAATATCAGCCTCGACTATCGAGACTATACAAGGATCTACCTCAGTCGCACACAAGCAGAGGCTCTGGCAGCTTTTGCCAACA
LpLp	ATCGAGACTATACAAGGATCTACCTCAGTCGCAGTCAGCTCCGACTTGTAAATATCAGCCTCGACTATCGAGACTATACAAGGATCTACCTCAGTCGCAGTCAGCTCCGACTTGTAAATATCAGCCTCGACT
LpSA	ATCGAGACTATACAAGGATCTACCTCAGTCGCAGTCAGCTCCGACTTGTAAATATCAGCCTCGACTCACAAGCAGAGGCTCTGGCAGCTTTTGCCAACATATTTATTTATTTATTTGTTTGTTTGTTTTATT
LpSB	ATCGAGACTATACAAGGATCTACCTCAGTCGCAGTCAGCTCCGACTTGTAAATATCAGCCTCGACTCACAAGCAGAGGCTCTGGCAGCTTTTGCCAACAATCAGCCTCGACTGTGCCTTCTAGTTGCCAGCC
LpSL	ATCGAGACTATACAAGGATCTACCTCAGTCGCAGTCAGCTCCGACTTGTAAATATCAGCCTCGACTCACAAGCAGAGGCTCTGGCAGCTTTTGCCAACAATCGAGACTATACAAGGATCTACCTCAGTCGCA
LpSS	ATCGAGACTATACAAGGATCTACCTCAGTCGCAGTCAGCTCCGACTTGTAAATATCAGCCTCGACTCACAAGCAGAGGCTCTGGCAGCTTTTGCCAACACACAAGCAGAGGCTCTGGCAGCTTTTGCCAACA
LpSp	ATCGAGACTATACAAGGATCTACCTCAGTCGCAGTCAGCTCCGACTTGTAAATATCAGCCTCGACTCACAAGCAGAGGCTCTGGCAGCTTTTGCCAACAGTCAGCTCCGACTTGTAAATATCAGCCTCGACT
LppA	ATCGAGACTATACAAGGATCTACCTCAGTCGCAGTCAGCTCCGACTTGTAAATATCAGCCTCGACTGTCAGCTCCGACTTGTAAATATCAGCCTCGACTTATTTATTTATTTATTTGTTTGTTTGTTTTATT
LppB	ATCGAGACTATACAAGGATCTACCTCAGTCGCAGTCAGCTCCGACTTGTAAATATCAGCCTCGACTGTCAGCTCCGACTTGTAAATATCAGCCTCGACTATCAGCCTCGACTGTGCCTTCTAGTTGCCAGCC
LppL	ATCGAGACTATACAAGGATCTACCTCAGTCGCAGTCAGCTCCGACTTGTAAATATCAGCCTCGACTGTCAGCTCCGACTTGTAAATATCAGCCTCGACTATCGAGACTATACAAGGATCTACCTCAGTCGCA
LppS	ATCGAGACTATACAAGGATCTACCTCAGTCGCAGTCAGCTCCGACTTGTAAATATCAGCCTCGACTGTCAGCTCCGACTTGTAAATATCAGCCTCGACTCACAAGCAGAGGCTCTGGCAGCTTTTGCCAACA
Lppp	ATCGAGACTATACAAGGATCTACCTCAGTCGCAGTCAGCTCCGACTTGTAAATATCAGCCTCGACTGTCAGCTCCGACTTGTAAATATCAGCCTCGACTGTCAGCTCCGACTTGTAAATATCAGCCTCGACT
SAAA	CACAAGCAGAGGCTCTGGCAGCTTTTGCCAACATATTTATTTATTTATTTGTTTGTTTGTTTTATTTATTTATTTATTTATTTGTTTGTTTGTTTTATTTATTTATTTATTTATTTGTTTGTTTGTTTTATT
SAAB	CACAAGCAGAGGCTCTGGCAGCTTTTGCCAACATATTTATTTATTTATTTGTTTGTTTGTTTTATTTATTTATTTATTTATTTGTTTGTTTGTTTTATTATCAGCCTCGACTGTGCCTTCTAGTTGCCAGCC
SAAL	CACAAGCAGAGGCTCTGGCAGCTTTTGCCAACATATTTATTTATTTATTTGTTTGTTTGTTTTATTTATTTATTTATTTATTTGTTTGTTTGTTTTATTATCGAGACTATACAAGGATCTACCTCAGTCGCA
SAAS	CACAAGCAGAGGCTCTGGCAGCTTTTGCCAACATATTTATTTATTTATTTGTTTGTTTGTTTTATTTATTTATTTATTTATTTGTTTGTTTGTTTTATTCACAAGCAGAGGCTCTGGCAGCTTTTGCCAACA
SAAp	CACAAGCAGAGGCTCTGGCAGCTTTTGCCAACATATTTATTTATTTATTTGTTTGTTTGTTTTATTTATTTATTTATTTATTTGTTTGTTTGTTTTATTGTCAGCTCCGACTTGTAAATATCAGCCTCGACT
SABA	CACAAGCAGAGGCTCTGGCAGCTTTTGCCAACATATTTATTTATTTATTTGTTTGTTTGTTTTATTATCAGCCTCGACTGTGCCTTCTAGTTGCCAGCCTATTTATTTATTTATTTGTTTGTTTGTTTTATT
SABB	CACAAGCAGAGGCTCTGGCAGCTTTTGCCAACATATTTATTTATTTATTTGTTTGTTTGTTTTATTATCAGCCTCGACTGTGCCTTCTAGTTGCCAGCCATCAGCCTCGACTGTGCCTTCTAGTTGCCAGCC
SABL	CACAAGCAGAGGCTCTGGCAGCTTTTGCCAACATATTTATTTATTTATTTGTTTGTTTGTTTTATTATCAGCCTCGACTGTGCCTTCTAGTTGCCAGCCATCGAGACTATACAAGGATCTACCTCAGTCGCA
SABS	CACAAGCAGAGGCTCTGGCAGCTTTTGCCAACATATTTATTTATTTATTTGTTTGTTTGTTTTATTATCAGCCTCGACTGTGCCTTCTAGTTGCCAGCCCACAAGCAGAGGCTCTGGCAGCTTTTGCCAACA
SABp	CACAAGCAGAGGCTCTGGCAGCTTTTGCCAACATATTTATTTATTTATTTGTTTGTTTGTTTTATTATCAGCCTCGACTGTGCCTTCTAGTTGCCAGCCGTCAGCTCCGACTTGTAAATATCAGCCTCGACT
SALA	CACAAGCAGAGGCTCTGGCAGCTTTTGCCAACATATTTATTTATTTATTTGTTTGTTTGTTTTATTATCGAGACTATACAAGGATCTACCTCAGTCGCATATTTATTTATTTATTTGTTTGTTTGTTTTATT
SALB	CACAAGCAGAGGCTCTGGCAGCTTTTGCCAACATATTTATTTATTTATTTGTTTGTTTGTTTTATTATCGAGACTATACAAGGATCTACCTCAGTCGCAATCAGCCTCGACTGTGCCTTCTAGTTGCCAGCC
SALL	CACAAGCAGAGGCTCTGGCAGCTTTTGCCAACATATTTATTTATTTATTTGTTTGTTTGTTTTATTATCGAGACTATACAAGGATCTACCTCAGTCGCAATCGAGACTATACAAGGATCTACCTCAGTCGCA
SALS	CACAAGCAGAGGCTCTGGCAGCTTTTGCCAACATATTTATTTATTTATTTGTTTGTTTGTTTTATTATCGAGACTATACAAGGATCTACCTCAGTCGCACACAAGCAGAGGCTCTGGCAGCTTTTGCCAACA
SALp	CACAAGCAGAGGCTCTGGCAGCTTTTGCCAACATATTTATTTATTTATTTGTTTGTTTGTTTTATTATCGAGACTATACAAGGATCTACCTCAGTCGCAGTCAGCTCCGACTTGTAAATATCAGCCTCGACT
SASA	CACAAGCAGAGGCTCTGGCAGCTTTTGCCAACATATTTATTTATTTATTTGTTTGTTTGTTTTATTCACAAGCAGAGGCTCTGGCAGCTTTTGCCAACATATTTATTTATTTATTTGTTTGTTTGTTTTATT
SASB	CACAAGCAGAGGCTCTGGCAGCTTTTGCCAACATATTTATTTATTTATTTGTTTGTTTGTTTTATTCACAAGCAGAGGCTCTGGCAGCTTTTGCCAACAATCAGCCTCGACTGTGCCTTCTAGTTGCCAGCC
SASL	CACAAGCAGAGGCTCTGGCAGCTTTTGCCAACATATTTATTTATTTATTTGTTTGTTTGTTTTATTCACAAGCAGAGGCTCTGGCAGCTTTTGCCAACAATCGAGACTATACAAGGATCTACCTCAGTCGCA
SASS	CACAAGCAGAGGCTCTGGCAGCTTTTGCCAACATATTTATTTATTTATTTGTTTGTTTGTTTTATTCACAAGCAGAGGCTCTGGCAGCTTTTGCCAACACACAAGCAGAGGCTCTGGCAGCTTTTGCCAACA
SASp	CACAAGCAGAGGCTCTGGCAGCTTTTGCCAACATATTTATTTATTTATTTGTTTGTTTGTTTTATTCACAAGCAGAGGCTCTGGCAGCTTTTGCCAACAGTCAGCTCCGACTTGTAAATATCAGCCTCGACT
SApA	CACAAGCAGAGGCTCTGGCAGCTTTTGCCAACATATTTATTTATTTATTTGTTTGTTTGTTTTATTGTCAGCTCCGACTTGTAAATATCAGCCTCGACTTATTTATTTATTTATTTGTTTGTTTGTTTTATT
SApB	CACAAGCAGAGGCTCTGGCAGCTTTTGCCAACATATTTATTTATTTATTTGTTTGTTTGTTTTATTGTCAGCTCCGACTTGTAAATATCAGCCTCGACTATCAGCCTCGACTGTGCCTTCTAGTTGCCAGCC
SApL	CACAAGCAGAGGCTCTGGCAGCTTTTGCCAACATATTTATTTATTTATTTGTTTGTTTGTTTTATTGTCAGCTCCGACTTGTAAATATCAGCCTCGACTATCGAGACTATACAAGGATCTACCTCAGTCGCA
SApS	CACAAGCAGAGGCTCTGGCAGCTTTTGCCAACATATTTATTTATTTATTTGTTTGTTTGTTTTATTGTCAGCTCCGACTTGTAAATATCAGCCTCGACTCACAAGCAGAGGCTCTGGCAGCTTTTGCCAACA
SApp	CACAAGCAGAGGCTCTGGCAGCTTTTGCCAACATATTTATTTATTTATTTGTTTGTTTGTTTTATTGTCAGCTCCGACTTGTAAATATCAGCCTCGACTGTCAGCTCCGACTTGTAAATATCAGCCTCGACT
SBAA	CACAAGCAGAGGCTCTGGCAGCTTTTGCCAACAATCAGCCTCGACTGTGCCTTCTAGTTGCCAGCCTATTTATTTATTTATTTGTTTGTTTGTTTTATTTATTTATTTATTTATTTGTTTGTTTGTTTTATT
SBAB	CACAAGCAGAGGCTCTGGCAGCTTTTGCCAACAATCAGCCTCGACTGTGCCTTCTAGTTGCCAGCCTATTTATTTATTTATTTGTTTGTTTGTTTTATTATCAGCCTCGACTGTGCCTTCTAGTTGCCAGCC
SBAL	CACAAGCAGAGGCTCTGGCAGCTTTTGCCAACAATCAGCCTCGACTGTGCCTTCTAGTTGCCAGCCTATTTATTTATTTATTTGTTTGTTTGTTTTATTATCGAGACTATACAAGGATCTACCTCAGTCGCA
SBAS	CACAAGCAGAGGCTCTGGCAGCTTTTGCCAACAATCAGCCTCGACTGTGCCTTCTAGTTGCCAGCCTATTTATTTATTTATTTGTTTGTTTGTTTTATTCACAAGCAGAGGCTCTGGCAGCTTTTGCCAACA
SBAp	CACAAGCAGAGGCTCTGGCAGCTTTTGCCAACAATCAGCCTCGACTGTGCCTTCTAGTTGCCAGCCTATTTATTTATTTATTTGTTTGTTTGTTTTATTGTCAGCTCCGACTTGTAAATATCAGCCTCGACT
SBBA	CACAAGCAGAGGCTCTGGCAGCTTTTGCCAACAATCAGCCTCGACTGTGCCTTCTAGTTGCCAGCCATCAGCCTCGACTGTGCCTTCTAGTTGCCAGCCTATTTATTTATTTATTTGTTTGTTTGTTTTATT
SBBB	CACAAGCAGAGGCTCTGGCAGCTTTTGCCAACAATCAGCCTCGACTGTGCCTTCTAGTTGCCAGCCATCAGCCTCGACTGTGCCTTCTAGTTGCCAGCCATCAGCCTCGACTGTGCCTTCTAGTTGCCAGCC
SBBL	CACAAGCAGAGGCTCTGGCAGCTTTTGCCAACAATCAGCCTCGACTGTGCCTTCTAGTTGCCAGCCATCAGCCTCGACTGTGCCTTCTAGTTGCCAGCCATCGAGACTATACAAGGATCTACCTCAGTCGCA
SBBS	CACAAGCAGAGGCTCTGGCAGCTTTTGCCAACAATCAGCCTCGACTGTGCCTTCTAGTTGCCAGCCATCAGCCTCGACTGTGCCTTCTAGTTGCCAGCCCACAAGCAGAGGCTCTGGCAGCTTTTGCCAACA
SBBp	CACAAGCAGAGGCTCTGGCAGCTTTTGCCAACAATCAGCCTCGACTGTGCCTTCTAGTTGCCAGCCATCAGCCTCGACTGTGCCTTCTAGTTGCCAGCCGTCAGCTCCGACTTGTAAATATCAGCCTCGACT
SBLA	CACAAGCAGAGGCTCTGGCAGCTTTTGCCAACAATCAGCCTCGACTGTGCCTTCTAGTTGCCAGCCATCGAGACTATACAAGGATCTACCTCAGTCGCATATTTATTTATTTATTTGTTTGTTTGTTTTATT
SBLB	CACAAGCAGAGGCTCTGGCAGCTTTTGCCAACAATCAGCCTCGACTGTGCCTTCTAGTTGCCAGCCATCGAGACTATACAAGGATCTACCTCAGTCGCAATCAGCCTCGACTGTGCCTTCTAGTTGCCAGCC
SBLL	CACAAGCAGAGGCTCTGGCAGCTTTTGCCAACAATCAGCCTCGACTGTGCCTTCTAGTTGCCAGCCATCGAGACTATACAAGGATCTACCTCAGTCGCAATCGAGACTATACAAGGATCTACCTCAGTCGCA
SBLS	CACAAGCAGAGGCTCTGGCAGCTTTTGCCAACAATCAGCCTCGACTGTGCCTTCTAGTTGCCAGCCATCGAGACTATACAAGGATCTACCTCAGTCGCACACAAGCAGAGGCTCTGGCAGCTTTTGCCAACA
SBLp	CACAAGCAGAGGCTCTGGCAGCTTTTGCCAACAATCAGCCTCGACTGTGCCTTCTAGTTGCCAGCCATCGAGACTATACAAGGATCTACCTCAGTCGCAGTCAGCTCCGACTTGTAAATATCAGCCTCGACT
SBSA	CACAAGCAGAGGCTCTGGCAGCTTTTGCCAACAATCAGCCTCGACTGTGCCTTCTAGTTGCCAGCCCACAAGCAGAGGCTCTGGCAGCTTTTGCCAACATATTTATTTATTTATTTGTTTGTTTGTTTTATT
SBSB	CACAAGCAGAGGCTCTGGCAGCTTTTGCCAACAATCAGCCTCGACTGTGCCTTCTAGTTGCCAGCCCACAAGCAGAGGCTCTGGCAGCTTTTGCCAACAATCAGCCTCGACTGTGCCTTCTAGTTGCCAGCC
SBSL	CACAAGCAGAGGCTCTGGCAGCTTTTGCCAACAATCAGCCTCGACTGTGCCTTCTAGTTGCCAGCCCACAAGCAGAGGCTCTGGCAGCTTTTGCCAACAATCGAGACTATACAAGGATCTACCTCAGTCGCA
SBSS	CACAAGCAGAGGCTCTGGCAGCTTTTGCCAACAATCAGCCTCGACTGTGCCTTCTAGTTGCCAGCCCACAAGCAGAGGCTCTGGCAGCTTTTGCCAACACACAAGCAGAGGCTCTGGCAGCTTTTGCCAACA
SBSp	CACAAGCAGAGGCTCTGGCAGCTTTTGCCAACAATCAGCCTCGACTGTGCCTTCTAGTTGCCAGCCCACAAGCAGAGGCTCTGGCAGCTTTTGCCAACAGTCAGCTCCGACTTGTAAATATCAGCCTCGACT
SBpA	CACAAGCAGAGGCTCTGGCAGCTTTTGCCAACAATCAGCCTCGACTGTGCCTTCTAGTTGCCAGCCGTCAGCTCCGACTTGTAAATATCAGCCTCGACTTATTTATTTATTTATTTGTTTGTTTGTTTTATT
SBpB	CACAAGCAGAGGCTCTGGCAGCTTTTGCCAACAATCAGCCTCGACTGTGCCTTCTAGTTGCCAGCCGTCAGCTCCGACTTGTAAATATCAGCCTCGACTATCAGCCTCGACTGTGCCTTCTAGTTGCCAGCC
SBpL	CACAAGCAGAGGCTCTGGCAGCTTTTGCCAACAATCAGCCTCGACTGTGCCTTCTAGTTGCCAGCCGTCAGCTCCGACTTGTAAATATCAGCCTCGACTATCGAGACTATACAAGGATCTACCTCAGTCGCA
SBpS	CACAAGCAGAGGCTCTGGCAGCTTTTGCCAACAATCAGCCTCGACTGTGCCTTCTAGTTGCCAGCCGTCAGCTCCGACTTGTAAATATCAGCCTCGACTCACAAGCAGAGGCTCTGGCAGCTTTTGCCAACA
SBpp	CACAAGCAGAGGCTCTGGCAGCTTTTGCCAACAATCAGCCTCGACTGTGCCTTCTAGTTGCCAGCCGTCAGCTCCGACTTGTAAATATCAGCCTCGACTGTCAGCTCCGACTTGTAAATATCAGCCTCGACT
SLAA	CACAAGCAGAGGCTCTGGCAGCTTTTGCCAACAATCGAGACTATACAAGGATCTACCTCAGTCGCATATTTATTTATTTATTTGTTTGTTTGTTTTATTTATTTATTTATTTATTTGTTTGTTTGTTTTATT
SLAB	CACAAGCAGAGGCTCTGGCAGCTTTTGCCAACAATCGAGACTATACAAGGATCTACCTCAGTCGCATATTTATTTATTTATTTGTTTGTTTGTTTTATTATCAGCCTCGACTGTGCCTTCTAGTTGCCAGCC
SLAL	CACAAGCAGAGGCTCTGGCAGCTTTTGCCAACAATCGAGACTATACAAGGATCTACCTCAGTCGCATATTTATTTATTTATTTGTTTGTTTGTTTTATTATCGAGACTATACAAGGATCTACCTCAGTCGCA
SLAS	CACAAGCAGAGGCTCTGGCAGCTTTTGCCAACAATCGAGACTATACAAGGATCTACCTCAGTCGCATATTTATTTATTTATTTGTTTGTTTGTTTTATTCACAAGCAGAGGCTCTGGCAGCTTTTGCCAACA
SLAp	CACAAGCAGAGGCTCTGGCAGCTTTTGCCAACAATCGAGACTATACAAGGATCTACCTCAGTCGCATATTTATTTATTTATTTGTTTGTTTGTTTTATTGTCAGCTCCGACTTGTAAATATCAGCCTCGACT
SLBA	CACAAGCAGAGGCTCTGGCAGCTTTTGCCAACAATCGAGACTATACAAGGATCTACCTCAGTCGCAATCAGCCTCGACTGTGCCTTCTAGTTGCCAGCCTATTTATTTATTTATTTGTTTGTTTGTTTTATT
SLBB	CACAAGCAGAGGCTCTGGCAGCTTTTGCCAACAATCGAGACTATACAAGGATCTACCTCAGTCGCAATCAGCCTCGACTGTGCCTTCTAGTTGCCAGCCATCAGCCTCGACTGTGCCTTCTAGTTGCCAGCC
SLBL	CACAAGCAGAGGCTCTGGCAGCTTTTGCCAACAATCGAGACTATACAAGGATCTACCTCAGTCGCAATCAGCCTCGACTGTGCCTTCTAGTTGCCAGCCATCGAGACTATACAAGGATCTACCTCAGTCGCA
SLBS	CACAAGCAGAGGCTCTGGCAGCTTTTGCCAACAATCGAGACTATACAAGGATCTACCTCAGTCGCAATCAGCCTCGACTGTGCCTTCTAGTTGCCAGCCCACAAGCAGAGGCTCTGGCAGCTTTTGCCAACA
SLBp	CACAAGCAGAGGCTCTGGCAGCTTTTGCCAACAATCGAGACTATACAAGGATCTACCTCAGTCGCAATCAGCCTCGACTGTGCCTTCTAGTTGCCAGCCGTCAGCTCCGACTTGTAAATATCAGCCTCGACT
SLLA	CACAAGCAGAGGCTCTGGCAGCTTTTGCCAACAATCGAGACTATACAAGGATCTACCTCAGTCGCAATCGAGACTATACAAGGATCTACCTCAGTCGCATATTTATTTATTTATTTGTTTGTTTGTTTTATT
SLLB	CACAAGCAGAGGCTCTGGCAGCTTTTGCCAACAATCGAGACTATACAAGGATCTACCTCAGTCGCAATCGAGACTATACAAGGATCTACCTCAGTCGCAATCAGCCTCGACTGTGCCTTCTAGTTGCCAGCC
SLLL	CACAAGCAGAGGCTCTGGCAGCTTTTGCCAACAATCGAGACTATACAAGGATCTACCTCAGTCGCAATCGAGACTATACAAGGATCTACCTCAGTCGCAATCGAGACTATACAAGGATCTACCTCAGTCGCA
SLLS	CACAAGCAGAGGCTCTGGCAGCTTTTGCCAACAATCGAGACTATACAAGGATCTACCTCAGTCGCAATCGAGACTATACAAGGATCTACCTCAGTCGCACACAAGCAGAGGCTCTGGCAGCTTTTGCCAACA
SLLp	CACAAGCAGAGGCTCTGGCAGCTTTTGCCAACAATCGAGACTATACAAGGATCTACCTCAGTCGCAATCGAGACTATACAAGGATCTACCTCAGTCGCAGTCAGCTCCGACTTGTAAATATCAGCCTCGACT
SLSA	CACAAGCAGAGGCTCTGGCAGCTTTTGCCAACAATCGAGACTATACAAGGATCTACCTCAGTCGCACACAAGCAGAGGCTCTGGCAGCTTTTGCCAACATATTTATTTATTTATTTGTTTGTTTGTTTTATT
SLSB	CACAAGCAGAGGCTCTGGCAGCTTTTGCCAACAATCGAGACTATACAAGGATCTACCTCAGTCGCACACAAGCAGAGGCTCTGGCAGCTTTTGCCAACAATCAGCCTCGACTGTGCCTTCTAGTTGCCAGCC
SLSL	CACAAGCAGAGGCTCTGGCAGCTTTTGCCAACAATCGAGACTATACAAGGATCTACCTCAGTCGCACACAAGCAGAGGCTCTGGCAGCTTTTGCCAACAATCGAGACTATACAAGGATCTACCTCAGTCGCA
SLSS	CACAAGCAGAGGCTCTGGCAGCTTTTGCCAACAATCGAGACTATACAAGGATCTACCTCAGTCGCACACAAGCAGAGGCTCTGGCAGCTTTTGCCAACACACAAGCAGAGGCTCTGGCAGCTTTTGCCAACA
SLSp	CACAAGCAGAGGCTCTGGCAGCTTTTGCCAACAATCGAGACTATACAAGGATCTACCTCAGTCGCACACAAGCAGAGGCTCTGGCAGCTTTTGCCAACAGTCAGCTCCGACTTGTAAATATCAGCCTCGACT
SLpA	CACAAGCAGAGGCTCTGGCAGCTTTTGCCAACAATCGAGACTATACAAGGATCTACCTCAGTCGCAGTCAGCTCCGACTTGTAAATATCAGCCTCGACTTATTTATTTATTTATTTGTTTGTTTGTTTTATT
SLpB	CACAAGCAGAGGCTCTGGCAGCTTTTGCCAACAATCGAGACTATACAAGGATCTACCTCAGTCGCAGTCAGCTCCGACTTGTAAATATCAGCCTCGACTATCAGCCTCGACTGTGCCTTCTAGTTGCCAGCC
SLpL	CACAAGCAGAGGCTCTGGCAGCTTTTGCCAACAATCGAGACTATACAAGGATCTACCTCAGTCGCAGTCAGCTCCGACTTGTAAATATCAGCCTCGACTATCGAGACTATACAAGGATCTACCTCAGTCGCA
SLpS	CACAAGCAGAGGCTCTGGCAGCTTTTGCCAACAATCGAGACTATACAAGGATCTACCTCAGTCGCAGTCAGCTCCGACTTGTAAATATCAGCCTCGACTCACAAGCAGAGGCTCTGGCAGCTTTTGCCAACA
SLpp	CACAAGCAGAGGCTCTGGCAGCTTTTGCCAACAATCGAGACTATACAAGGATCTACCTCAGTCGCAGTCAGCTCCGACTTGTAAATATCAGCCTCGACTGTCAGCTCCGACTTGTAAATATCAGCCTCGACT
SMARCAD1	ATCGATCATGTGTTAATACTACCTCCGTCGCAAATCGATCATGTGTTAATACTACCTCCGTCGCAAATCGATCATGTGTTAATACTACCTCCGTCGCAAATCGATCATGTGTTAATACTACCTCCGTCGCAA
SSAA	CACAAGCAGAGGCTCTGGCAGCTTTTGCCAACACACAAGCAGAGGCTCTGGCAGCTTTTGCCAACATATTTATTTATTTATTTGTTTGTTTGTTTTATTTATTTATTTATTTATTTGTTTGTTTGTTTTATT
SSAB	CACAAGCAGAGGCTCTGGCAGCTTTTGCCAACACACAAGCAGAGGCTCTGGCAGCTTTTGCCAACATATTTATTTATTTATTTGTTTGTTTGTTTTATTATCAGCCTCGACTGTGCCTTCTAGTTGCCAGCC
SSAL	CACAAGCAGAGGCTCTGGCAGCTTTTGCCAACACACAAGCAGAGGCTCTGGCAGCTTTTGCCAACATATTTATTTATTTATTTGTTTGTTTGTTTTATTATCGAGACTATACAAGGATCTACCTCAGTCGCA
SSAS	CACAAGCAGAGGCTCTGGCAGCTTTTGCCAACACACAAGCAGAGGCTCTGGCAGCTTTTGCCAACATATTTATTTATTTATTTGTTTGTTTGTTTTATTCACAAGCAGAGGCTCTGGCAGCTTTTGCCAACA
SSAp	CACAAGCAGAGGCTCTGGCAGCTTTTGCCAACACACAAGCAGAGGCTCTGGCAGCTTTTGCCAACATATTTATTTATTTATTTGTTTGTTTGTTTTATTGTCAGCTCCGACTTGTAAATATCAGCCTCGACT
SSBA	CACAAGCAGAGGCTCTGGCAGCTTTTGCCAACACACAAGCAGAGGCTCTGGCAGCTTTTGCCAACAATCAGCCTCGACTGTGCCTTCTAGTTGCCAGCCTATTTATTTATTTATTTGTTTGTTTGTTTTATT
SSBB	CACAAGCAGAGGCTCTGGCAGCTTTTGCCAACACACAAGCAGAGGCTCTGGCAGCTTTTGCCAACAATCAGCCTCGACTGTGCCTTCTAGTTGCCAGCCATCAGCCTCGACTGTGCCTTCTAGTTGCCAGCC
SSBL	CACAAGCAGAGGCTCTGGCAGCTTTTGCCAACACACAAGCAGAGGCTCTGGCAGCTTTTGCCAACAATCAGCCTCGACTGTGCCTTCTAGTTGCCAGCCATCGAGACTATACAAGGATCTACCTCAGTCGCA
SSBS	CACAAGCAGAGGCTCTGGCAGCTTTTGCCAACACACAAGCAGAGGCTCTGGCAGCTTTTGCCAACAATCAGCCTCGACTGTGCCTTCTAGTTGCCAGCCCACAAGCAGAGGCTCTGGCAGCTTTTGCCAACA
SSBp	CACAAGCAGAGGCTCTGGCAGCTTTTGCCAACACACAAGCAGAGGCTCTGGCAGCTTTTGCCAACAATCAGCCTCGACTGTGCCTTCTAGTTGCCAGCCGTCAGCTCCGACTTGTAAATATCAGCCTCGACT
SSLA	CACAAGCAGAGGCTCTGGCAGCTTTTGCCAACACACAAGCAGAGGCTCTGGCAGCTTTTGCCAACAATCGAGACTATACAAGGATCTACCTCAGTCGCATATTTATTTATTTATTTGTTTGTTTGTTTTATT
SSLB	CACAAGCAGAGGCTCTGGCAGCTTTTGCCAACACACAAGCAGAGGCTCTGGCAGCTTTTGCCAACAATCGAGACTATACAAGGATCTACCTCAGTCGCAATCAGCCTCGACTGTGCCTTCTAGTTGCCAGCC
SSLL	CACAAGCAGAGGCTCTGGCAGCTTTTGCCAACACACAAGCAGAGGCTCTGGCAGCTTTTGCCAACAATCGAGACTATACAAGGATCTACCTCAGTCGCAATCGAGACTATACAAGGATCTACCTCAGTCGCA
SSLS	CACAAGCAGAGGCTCTGGCAGCTTTTGCCAACACACAAGCAGAGGCTCTGGCAGCTTTTGCCAACAATCGAGACTATACAAGGATCTACCTCAGTCGCACACAAGCAGAGGCTCTGGCAGCTTTTGCCAACA
SSLp	CACAAGCAGAGGCTCTGGCAGCTTTTGCCAACACACAAGCAGAGGCTCTGGCAGCTTTTGCCAACAATCGAGACTATACAAGGATCTACCTCAGTCGCAGTCAGCTCCGACTTGTAAATATCAGCCTCGACT
SSSA	CACAAGCAGAGGCTCTGGCAGCTTTTGCCAACACACAAGCAGAGGCTCTGGCAGCTTTTGCCAACACACAAGCAGAGGCTCTGGCAGCTTTTGCCAACATATTTATTTATTTATTTGTTTGTTTGTTTTATT
SSSB	CACAAGCAGAGGCTCTGGCAGCTTTTGCCAACACACAAGCAGAGGCTCTGGCAGCTTTTGCCAACACACAAGCAGAGGCTCTGGCAGCTTTTGCCAACAATCAGCCTCGACTGTGCCTTCTAGTTGCCAGCC
SSSL	CACAAGCAGAGGCTCTGGCAGCTTTTGCCAACACACAAGCAGAGGCTCTGGCAGCTTTTGCCAACACACAAGCAGAGGCTCTGGCAGCTTTTGCCAACAATCGAGACTATACAAGGATCTACCTCAGTCGCA
SSSS	CACAAGCAGAGGCTCTGGCAGCTTTTGCCAACACACAAGCAGAGGCTCTGGCAGCTTTTGCCAACACACAAGCAGAGGCTCTGGCAGCTTTTGCCAACACACAAGCAGAGGCTCTGGCAGCTTTTGCCAACA
SSSp	CACAAGCAGAGGCTCTGGCAGCTTTTGCCAACACACAAGCAGAGGCTCTGGCAGCTTTTGCCAACACACAAGCAGAGGCTCTGGCAGCTTTTGCCAACAGTCAGCTCCGACTTGTAAATATCAGCCTCGACT
SSpA	CACAAGCAGAGGCTCTGGCAGCTTTTGCCAACACACAAGCAGAGGCTCTGGCAGCTTTTGCCAACAGTCAGCTCCGACTTGTAAATATCAGCCTCGACTTATTTATTTATTTATTTGTTTGTTTGTTTTATT
SSpB	CACAAGCAGAGGCTCTGGCAGCTTTTGCCAACACACAAGCAGAGGCTCTGGCAGCTTTTGCCAACAGTCAGCTCCGACTTGTAAATATCAGCCTCGACTATCAGCCTCGACTGTGCCTTCTAGTTGCCAGCC
SSpL	CACAAGCAGAGGCTCTGGCAGCTTTTGCCAACACACAAGCAGAGGCTCTGGCAGCTTTTGCCAACAGTCAGCTCCGACTTGTAAATATCAGCCTCGACTATCGAGACTATACAAGGATCTACCTCAGTCGCA
SSpS	CACAAGCAGAGGCTCTGGCAGCTTTTGCCAACACACAAGCAGAGGCTCTGGCAGCTTTTGCCAACAGTCAGCTCCGACTTGTAAATATCAGCCTCGACTCACAAGCAGAGGCTCTGGCAGCTTTTGCCAACA
SSpp	CACAAGCAGAGGCTCTGGCAGCTTTTGCCAACACACAAGCAGAGGCTCTGGCAGCTTTTGCCAACAGTCAGCTCCGACTTGTAAATATCAGCCTCGACTGTCAGCTCCGACTTGTAAATATCAGCCTCGACT
SpAA	CACAAGCAGAGGCTCTGGCAGCTTTTGCCAACAGTCAGCTCCGACTTGTAAATATCAGCCTCGACTTATTTATTTATTTATTTGTTTGTTTGTTTTATTTATTTATTTATTTATTTGTTTGTTTGTTTTATT
SpAB	CACAAGCAGAGGCTCTGGCAGCTTTTGCCAACAGTCAGCTCCGACTTGTAAATATCAGCCTCGACTTATTTATTTATTTATTTGTTTGTTTGTTTTATTATCAGCCTCGACTGTGCCTTCTAGTTGCCAGCC
SpAL	CACAAGCAGAGGCTCTGGCAGCTTTTGCCAACAGTCAGCTCCGACTTGTAAATATCAGCCTCGACTTATTTATTTATTTATTTGTTTGTTTGTTTTATTATCGAGACTATACAAGGATCTACCTCAGTCGCA
SpAS	CACAAGCAGAGGCTCTGGCAGCTTTTGCCAACAGTCAGCTCCGACTTGTAAATATCAGCCTCGACTTATTTATTTATTTATTTGTTTGTTTGTTTTATTCACAAGCAGAGGCTCTGGCAGCTTTTGCCAACA
SpAp	CACAAGCAGAGGCTCTGGCAGCTTTTGCCAACAGTCAGCTCCGACTTGTAAATATCAGCCTCGACTTATTTATTTATTTATTTGTTTGTTTGTTTTATTGTCAGCTCCGACTTGTAAATATCAGCCTCGACT
SpBA	CACAAGCAGAGGCTCTGGCAGCTTTTGCCAACAGTCAGCTCCGACTTGTAAATATCAGCCTCGACTATCAGCCTCGACTGTGCCTTCTAGTTGCCAGCCTATTTATTTATTTATTTGTTTGTTTGTTTTATT
SpBB	CACAAGCAGAGGCTCTGGCAGCTTTTGCCAACAGTCAGCTCCGACTTGTAAATATCAGCCTCGACTATCAGCCTCGACTGTGCCTTCTAGTTGCCAGCCATCAGCCTCGACTGTGCCTTCTAGTTGCCAGCC
SpBL	CACAAGCAGAGGCTCTGGCAGCTTTTGCCAACAGTCAGCTCCGACTTGTAAATATCAGCCTCGACTATCAGCCTCGACTGTGCCTTCTAGTTGCCAGCCATCGAGACTATACAAGGATCTACCTCAGTCGCA
SpBS	CACAAGCAGAGGCTCTGGCAGCTTTTGCCAACAGTCAGCTCCGACTTGTAAATATCAGCCTCGACTATCAGCCTCGACTGTGCCTTCTAGTTGCCAGCCCACAAGCAGAGGCTCTGGCAGCTTTTGCCAACA
SpBp	CACAAGCAGAGGCTCTGGCAGCTTTTGCCAACAGTCAGCTCCGACTTGTAAATATCAGCCTCGACTATCAGCCTCGACTGTGCCTTCTAGTTGCCAGCCGTCAGCTCCGACTTGTAAATATCAGCCTCGACT
SpLA	CACAAGCAGAGGCTCTGGCAGCTTTTGCCAACAGTCAGCTCCGACTTGTAAATATCAGCCTCGACTATCGAGACTATACAAGGATCTACCTCAGTCGCATATTTATTTATTTATTTGTTTGTTTGTTTTATT
SpLB	CACAAGCAGAGGCTCTGGCAGCTTTTGCCAACAGTCAGCTCCGACTTGTAAATATCAGCCTCGACTATCGAGACTATACAAGGATCTACCTCAGTCGCAATCAGCCTCGACTGTGCCTTCTAGTTGCCAGCC
SpLL	CACAAGCAGAGGCTCTGGCAGCTTTTGCCAACAGTCAGCTCCGACTTGTAAATATCAGCCTCGACTATCGAGACTATACAAGGATCTACCTCAGTCGCAATCGAGACTATACAAGGATCTACCTCAGTCGCA
SpLS	CACAAGCAGAGGCTCTGGCAGCTTTTGCCAACAGTCAGCTCCGACTTGTAAATATCAGCCTCGACTATCGAGACTATACAAGGATCTACCTCAGTCGCACACAAGCAGAGGCTCTGGCAGCTTTTGCCAACA
SpLp	CACAAGCAGAGGCTCTGGCAGCTTTTGCCAACAGTCAGCTCCGACTTGTAAATATCAGCCTCGACTATCGAGACTATACAAGGATCTACCTCAGTCGCAGTCAGCTCCGACTTGTAAATATCAGCCTCGACT
SpSA	CACAAGCAGAGGCTCTGGCAGCTTTTGCCAACAGTCAGCTCCGACTTGTAAATATCAGCCTCGACTCACAAGCAGAGGCTCTGGCAGCTTTTGCCAACATATTTATTTATTTATTTGTTTGTTTGTTTTATT
SpSB	CACAAGCAGAGGCTCTGGCAGCTTTTGCCAACAGTCAGCTCCGACTTGTAAATATCAGCCTCGACTCACAAGCAGAGGCTCTGGCAGCTTTTGCCAACAATCAGCCTCGACTGTGCCTTCTAGTTGCCAGCC
SpSL	CACAAGCAGAGGCTCTGGCAGCTTTTGCCAACAGTCAGCTCCGACTTGTAAATATCAGCCTCGACTCACAAGCAGAGGCTCTGGCAGCTTTTGCCAACAATCGAGACTATACAAGGATCTACCTCAGTCGCA
SpSS	CACAAGCAGAGGCTCTGGCAGCTTTTGCCAACAGTCAGCTCCGACTTGTAAATATCAGCCTCGACTCACAAGCAGAGGCTCTGGCAGCTTTTGCCAACACACAAGCAGAGGCTCTGGCAGCTTTTGCCAACA
SpSp	CACAAGCAGAGGCTCTGGCAGCTTTTGCCAACAGTCAGCTCCGACTTGTAAATATCAGCCTCGACTCACAAGCAGAGGCTCTGGCAGCTTTTGCCAACAGTCAGCTCCGACTTGTAAATATCAGCCTCGACT
SppA	CACAAGCAGAGGCTCTGGCAGCTTTTGCCAACAGTCAGCTCCGACTTGTAAATATCAGCCTCGACTGTCAGCTCCGACTTGTAAATATCAGCCTCGACTTATTTATTTATTTATTTGTTTGTTTGTTTTATT
SppB	CACAAGCAGAGGCTCTGGCAGCTTTTGCCAACAGTCAGCTCCGACTTGTAAATATCAGCCTCGACTGTCAGCTCCGACTTGTAAATATCAGCCTCGACTATCAGCCTCGACTGTGCCTTCTAGTTGCCAGCC
SppL	CACAAGCAGAGGCTCTGGCAGCTTTTGCCAACAGTCAGCTCCGACTTGTAAATATCAGCCTCGACTGTCAGCTCCGACTTGTAAATATCAGCCTCGACTATCGAGACTATACAAGGATCTACCTCAGTCGCA
SppS	CACAAGCAGAGGCTCTGGCAGCTTTTGCCAACAGTCAGCTCCGACTTGTAAATATCAGCCTCGACTGTCAGCTCCGACTTGTAAATATCAGCCTCGACTCACAAGCAGAGGCTCTGGCAGCTTTTGCCAACA
Sppp	CACAAGCAGAGGCTCTGGCAGCTTTTGCCAACAGTCAGCTCCGACTTGTAAATATCAGCCTCGACTGTCAGCTCCGACTTGTAAATATCAGCCTCGACTGTCAGCTCCGACTTGTAAATATCAGCCTCGACT
pAAA	GTCAGCTCCGACTTGTAAATATCAGCCTCGACTTATTTATTTATTTATTTGTTTGTTTGTTTTATTTATTTATTTATTTATTTGTTTGTTTGTTTTATTTATTTATTTATTTATTTGTTTGTTTGTTTTATT
pAAB	GTCAGCTCCGACTTGTAAATATCAGCCTCGACTTATTTATTTATTTATTTGTTTGTTTGTTTTATTTATTTATTTATTTATTTGTTTGTTTGTTTTATTATCAGCCTCGACTGTGCCTTCTAGTTGCCAGCC
pAAL	GTCAGCTCCGACTTGTAAATATCAGCCTCGACTTATTTATTTATTTATTTGTTTGTTTGTTTTATTTATTTATTTATTTATTTGTTTGTTTGTTTTATTATCGAGACTATACAAGGATCTACCTCAGTCGCA
pAAS	GTCAGCTCCGACTTGTAAATATCAGCCTCGACTTATTTATTTATTTATTTGTTTGTTTGTTTTATTTATTTATTTATTTATTTGTTTGTTTGTTTTATTCACAAGCAGAGGCTCTGGCAGCTTTTGCCAACA
pAAp	GTCAGCTCCGACTTGTAAATATCAGCCTCGACTTATTTATTTATTTATTTGTTTGTTTGTTTTATTTATTTATTTATTTATTTGTTTGTTTGTTTTATTGTCAGCTCCGACTTGTAAATATCAGCCTCGACT
pABA	GTCAGCTCCGACTTGTAAATATCAGCCTCGACTTATTTATTTATTTATTTGTTTGTTTGTTTTATTATCAGCCTCGACTGTGCCTTCTAGTTGCCAGCCTATTTATTTATTTATTTGTTTGTTTGTTTTATT
pABB	GTCAGCTCCGACTTGTAAATATCAGCCTCGACTTATTTATTTATTTATTTGTTTGTTTGTTTTATTATCAGCCTCGACTGTGCCTTCTAGTTGCCAGCCATCAGCCTCGACTGTGCCTTCTAGTTGCCAGCC
pABL	GTCAGCTCCGACTTGTAAATATCAGCCTCGACTTATTTATTTATTTATTTGTTTGTTTGTTTTATTATCAGCCTCGACTGTGCCTTCTAGTTGCCAGCCATCGAGACTATACAAGGATCTACCTCAGTCGCA
pABS	GTCAGCTCCGACTTGTAAATATCAGCCTCGACTTATTTATTTATTTATTTGTTTGTTTGTTTTATTATCAGCCTCGACTGTGCCTTCTAGTTGCCAGCCCACAAGCAGAGGCTCTGGCAGCTTTTGCCAACA
pABp	GTCAGCTCCGACTTGTAAATATCAGCCTCGACTTATTTATTTATTTATTTGTTTGTTTGTTTTATTATCAGCCTCGACTGTGCCTTCTAGTTGCCAGCCGTCAGCTCCGACTTGTAAATATCAGCCTCGACT
pALA	GTCAGCTCCGACTTGTAAATATCAGCCTCGACTTATTTATTTATTTATTTGTTTGTTTGTTTTATTATCGAGACTATACAAGGATCTACCTCAGTCGCATATTTATTTATTTATTTGTTTGTTTGTTTTATT
pALB	GTCAGCTCCGACTTGTAAATATCAGCCTCGACTTATTTATTTATTTATTTGTTTGTTTGTTTTATTATCGAGACTATACAAGGATCTACCTCAGTCGCAATCAGCCTCGACTGTGCCTTCTAGTTGCCAGCC
pALL	GTCAGCTCCGACTTGTAAATATCAGCCTCGACTTATTTATTTATTTATTTGTTTGTTTGTTTTATTATCGAGACTATACAAGGATCTACCTCAGTCGCAATCGAGACTATACAAGGATCTACCTCAGTCGCA
pALS	GTCAGCTCCGACTTGTAAATATCAGCCTCGACTTATTTATTTATTTATTTGTTTGTTTGTTTTATTATCGAGACTATACAAGGATCTACCTCAGTCGCACACAAGCAGAGGCTCTGGCAGCTTTTGCCAACA
pALp	GTCAGCTCCGACTTGTAAATATCAGCCTCGACTTATTTATTTATTTATTTGTTTGTTTGTTTTATTATCGAGACTATACAAGGATCTACCTCAGTCGCAGTCAGCTCCGACTTGTAAATATCAGCCTCGACT
pASA	GTCAGCTCCGACTTGTAAATATCAGCCTCGACTTATTTATTTATTTATTTGTTTGTTTGTTTTATTCACAAGCAGAGGCTCTGGCAGCTTTTGCCAACATATTTATTTATTTATTTGTTTGTTTGTTTTATT
pASB	GTCAGCTCCGACTTGTAAATATCAGCCTCGACTTATTTATTTATTTATTTGTTTGTTTGTTTTATTCACAAGCAGAGGCTCTGGCAGCTTTTGCCAACAATCAGCCTCGACTGTGCCTTCTAGTTGCCAGCC
pASL	GTCAGCTCCGACTTGTAAATATCAGCCTCGACTTATTTATTTATTTATTTGTTTGTTTGTTTTATTCACAAGCAGAGGCTCTGGCAGCTTTTGCCAACAATCGAGACTATACAAGGATCTACCTCAGTCGCA
pASS	GTCAGCTCCGACTTGTAAATATCAGCCTCGACTTATTTATTTATTTATTTGTTTGTTTGTTTTATTCACAAGCAGAGGCTCTGGCAGCTTTTGCCAACACACAAGCAGAGGCTCTGGCAGCTTTTGCCAACA
pASp	GTCAGCTCCGACTTGTAAATATCAGCCTCGACTTATTTATTTATTTATTTGTTTGTTTGTTTTATTCACAAGCAGAGGCTCTGGCAGCTTTTGCCAACAGTCAGCTCCGACTTGTAAATATCAGCCTCGACT
pApA	GTCAGCTCCGACTTGTAAATATCAGCCTCGACTTATTTATTTATTTATTTGTTTGTTTGTTTTATTGTCAGCTCCGACTTGTAAATATCAGCCTCGACTTATTTATTTATTTATTTGTTTGTTTGTTTTATT
pApB	GTCAGCTCCGACTTGTAAATATCAGCCTCGACTTATTTATTTATTTATTTGTTTGTTTGTTTTATTGTCAGCTCCGACTTGTAAATATCAGCCTCGACTATCAGCCTCGACTGTGCCTTCTAGTTGCCAGCC
pApL	GTCAGCTCCGACTTGTAAATATCAGCCTCGACTTATTTATTTATTTATTTGTTTGTTTGTTTTATTGTCAGCTCCGACTTGTAAATATCAGCCTCGACTATCGAGACTATACAAGGATCTACCTCAGTCGCA
pApS	GTCAGCTCCGACTTGTAAATATCAGCCTCGACTTATTTATTTATTTATTTGTTTGTTTGTTTTATTGTCAGCTCCGACTTGTAAATATCAGCCTCGACTCACAAGCAGAGGCTCTGGCAGCTTTTGCCAACA
pApp	GTCAGCTCCGACTTGTAAATATCAGCCTCGACTTATTTATTTATTTATTTGTTTGTTTGTTTTATTGTCAGCTCCGACTTGTAAATATCAGCCTCGACTGTCAGCTCCGACTTGTAAATATCAGCCTCGACT
pBAA	GTCAGCTCCGACTTGTAAATATCAGCCTCGACTATCAGCCTCGACTGTGCCTTCTAGTTGCCAGCCTATTTATTTATTTATTTGTTTGTTTGTTTTATTTATTTATTTATTTATTTGTTTGTTTGTTTTATT
pBAB	GTCAGCTCCGACTTGTAAATATCAGCCTCGACTATCAGCCTCGACTGTGCCTTCTAGTTGCCAGCCTATTTATTTATTTATTTGTTTGTTTGTTTTATTATCAGCCTCGACTGTGCCTTCTAGTTGCCAGCC
pBAL	GTCAGCTCCGACTTGTAAATATCAGCCTCGACTATCAGCCTCGACTGTGCCTTCTAGTTGCCAGCCTATTTATTTATTTATTTGTTTGTTTGTTTTATTATCGAGACTATACAAGGATCTACCTCAGTCGCA
pBAS	GTCAGCTCCGACTTGTAAATATCAGCCTCGACTATCAGCCTCGACTGTGCCTTCTAGTTGCCAGCCTATTTATTTATTTATTTGTTTGTTTGTTTTATTCACAAGCAGAGGCTCTGGCAGCTTTTGCCAACA
pBAp	GTCAGCTCCGACTTGTAAATATCAGCCTCGACTATCAGCCTCGACTGTGCCTTCTAGTTGCCAGCCTATTTATTTATTTATTTGTTTGTTTGTTTTATTGTCAGCTCCGACTTGTAAATATCAGCCTCGACT
pBBA	GTCAGCTCCGACTTGTAAATATCAGCCTCGACTATCAGCCTCGACTGTGCCTTCTAGTTGCCAGCCATCAGCCTCGACTGTGCCTTCTAGTTGCCAGCCTATTTATTTATTTATTTGTTTGTTTGTTTTATT
pBBB	GTCAGCTCCGACTTGTAAATATCAGCCTCGACTATCAGCCTCGACTGTGCCTTCTAGTTGCCAGCCATCAGCCTCGACTGTGCCTTCTAGTTGCCAGCCATCAGCCTCGACTGTGCCTTCTAGTTGCCAGCC
pBBL	GTCAGCTCCGACTTGTAAATATCAGCCTCGACTATCAGCCTCGACTGTGCCTTCTAGTTGCCAGCCATCAGCCTCGACTGTGCCTTCTAGTTGCCAGCCATCGAGACTATACAAGGATCTACCTCAGTCGCA
pBBS	GTCAGCTCCGACTTGTAAATATCAGCCTCGACTATCAGCCTCGACTGTGCCTTCTAGTTGCCAGCCATCAGCCTCGACTGTGCCTTCTAGTTGCCAGCCCACAAGCAGAGGCTCTGGCAGCTTTTGCCAACA
pBBp	GTCAGCTCCGACTTGTAAATATCAGCCTCGACTATCAGCCTCGACTGTGCCTTCTAGTTGCCAGCCATCAGCCTCGACTGTGCCTTCTAGTTGCCAGCCGTCAGCTCCGACTTGTAAATATCAGCCTCGACT
pBLA	GTCAGCTCCGACTTGTAAATATCAGCCTCGACTATCAGCCTCGACTGTGCCTTCTAGTTGCCAGCCATCGAGACTATACAAGGATCTACCTCAGTCGCATATTTATTTATTTATTTGTTTGTTTGTTTTATT
pBLB	GTCAGCTCCGACTTGTAAATATCAGCCTCGACTATCAGCCTCGACTGTGCCTTCTAGTTGCCAGCCATCGAGACTATACAAGGATCTACCTCAGTCGCAATCAGCCTCGACTGTGCCTTCTAGTTGCCAGCC
pBLL	GTCAGCTCCGACTTGTAAATATCAGCCTCGACTATCAGCCTCGACTGTGCCTTCTAGTTGCCAGCCATCGAGACTATACAAGGATCTACCTCAGTCGCAATCGAGACTATACAAGGATCTACCTCAGTCGCA
pBLS	GTCAGCTCCGACTTGTAAATATCAGCCTCGACTATCAGCCTCGACTGTGCCTTCTAGTTGCCAGCCATCGAGACTATACAAGGATCTACCTCAGTCGCACACAAGCAGAGGCTCTGGCAGCTTTTGCCAACA
pBLp	GTCAGCTCCGACTTGTAAATATCAGCCTCGACTATCAGCCTCGACTGTGCCTTCTAGTTGCCAGCCATCGAGACTATACAAGGATCTACCTCAGTCGCAGTCAGCTCCGACTTGTAAATATCAGCCTCGACT
pBSA	GTCAGCTCCGACTTGTAAATATCAGCCTCGACTATCAGCCTCGACTGTGCCTTCTAGTTGCCAGCCCACAAGCAGAGGCTCTGGCAGCTTTTGCCAACATATTTATTTATTTATTTGTTTGTTTGTTTTATT
pBSB	GTCAGCTCCGACTTGTAAATATCAGCCTCGACTATCAGCCTCGACTGTGCCTTCTAGTTGCCAGCCCACAAGCAGAGGCTCTGGCAGCTTTTGCCAACAATCAGCCTCGACTGTGCCTTCTAGTTGCCAGCC
pBSL	GTCAGCTCCGACTTGTAAATATCAGCCTCGACTATCAGCCTCGACTGTGCCTTCTAGTTGCCAGCCCACAAGCAGAGGCTCTGGCAGCTTTTGCCAACAATCGAGACTATACAAGGATCTACCTCAGTCGCA
pBSS	GTCAGCTCCGACTTGTAAATATCAGCCTCGACTATCAGCCTCGACTGTGCCTTCTAGTTGCCAGCCCACAAGCAGAGGCTCTGGCAGCTTTTGCCAACACACAAGCAGAGGCTCTGGCAGCTTTTGCCAACA
pBSp	GTCAGCTCCGACTTGTAAATATCAGCCTCGACTATCAGCCTCGACTGTGCCTTCTAGTTGCCAGCCCACAAGCAGAGGCTCTGGCAGCTTTTGCCAACAGTCAGCTCCGACTTGTAAATATCAGCCTCGACT
pBpA	GTCAGCTCCGACTTGTAAATATCAGCCTCGACTATCAGCCTCGACTGTGCCTTCTAGTTGCCAGCCGTCAGCTCCGACTTGTAAATATCAGCCTCGACTTATTTATTTATTTATTTGTTTGTTTGTTTTATT
pBpB	GTCAGCTCCGACTTGTAAATATCAGCCTCGACTATCAGCCTCGACTGTGCCTTCTAGTTGCCAGCCGTCAGCTCCGACTTGTAAATATCAGCCTCGACTATCAGCCTCGACTGTGCCTTCTAGTTGCCAGCC
pBpL	GTCAGCTCCGACTTGTAAATATCAGCCTCGACTATCAGCCTCGACTGTGCCTTCTAGTTGCCAGCCGTCAGCTCCGACTTGTAAATATCAGCCTCGACTATCGAGACTATACAAGGATCTACCTCAGTCGCA
pBpS	GTCAGCTCCGACTTGTAAATATCAGCCTCGACTATCAGCCTCGACTGTGCCTTCTAGTTGCCAGCCGTCAGCTCCGACTTGTAAATATCAGCCTCGACTCACAAGCAGAGGCTCTGGCAGCTTTTGCCAACA
pBpp	GTCAGCTCCGACTTGTAAATATCAGCCTCGACTATCAGCCTCGACTGTGCCTTCTAGTTGCCAGCCGTCAGCTCCGACTTGTAAATATCAGCCTCGACTGTCAGCTCCGACTTGTAAATATCAGCCTCGACT
pLAA	GTCAGCTCCGACTTGTAAATATCAGCCTCGACTATCGAGACTATACAAGGATCTACCTCAGTCGCATATTTATTTATTTATTTGTTTGTTTGTTTTATTTATTTATTTATTTATTTGTTTGTTTGTTTTATT
pLAB	GTCAGCTCCGACTTGTAAATATCAGCCTCGACTATCGAGACTATACAAGGATCTACCTCAGTCGCATATTTATTTATTTATTTGTTTGTTTGTTTTATTATCAGCCTCGACTGTGCCTTCTAGTTGCCAGCC
pLAL	GTCAGCTCCGACTTGTAAATATCAGCCTCGACTATCGAGACTATACAAGGATCTACCTCAGTCGCATATTTATTTATTTATTTGTTTGTTTGTTTTATTATCGAGACTATACAAGGATCTACCTCAGTCGCA
pLAS	GTCAGCTCCGACTTGTAAATATCAGCCTCGACTATCGAGACTATACAAGGATCTACCTCAGTCGCATATTTATTTATTTATTTGTTTGTTTGTTTTATTCACAAGCAGAGGCTCTGGCAGCTTTTGCCAACA
pLAp	GTCAGCTCCGACTTGTAAATATCAGCCTCGACTATCGAGACTATACAAGGATCTACCTCAGTCGCATATTTATTTATTTATTTGTTTGTTTGTTTTATTGTCAGCTCCGACTTGTAAATATCAGCCTCGACT
pLBA	GTCAGCTCCGACTTGTAAATATCAGCCTCGACTATCGAGACTATACAAGGATCTACCTCAGTCGCAATCAGCCTCGACTGTGCCTTCTAGTTGCCAGCCTATTTATTTATTTATTTGTTTGTTTGTTTTATT
pLBB	GTCAGCTCCGACTTGTAAATATCAGCCTCGACTATCGAGACTATACAAGGATCTACCTCAGTCGCAATCAGCCTCGACTGTGCCTTCTAGTTGCCAGCCATCAGCCTCGACTGTGCCTTCTAGTTGCCAGCC
pLBL	GTCAGCTCCGACTTGTAAATATCAGCCTCGACTATCGAGACTATACAAGGATCTACCTCAGTCGCAATCAGCCTCGACTGTGCCTTCTAGTTGCCAGCCATCGAGACTATACAAGGATCTACCTCAGTCGCA
pLBS	GTCAGCTCCGACTTGTAAATATCAGCCTCGACTATCGAGACTATACAAGGATCTACCTCAGTCGCAATCAGCCTCGACTGTGCCTTCTAGTTGCCAGCCCACAAGCAGAGGCTCTGGCAGCTTTTGCCAACA
pLBp	GTCAGCTCCGACTTGTAAATATCAGCCTCGACTATCGAGACTATACAAGGATCTACCTCAGTCGCAATCAGCCTCGACTGTGCCTTCTAGTTGCCAGCCGTCAGCTCCGACTTGTAAATATCAGCCTCGACT
pLLA	GTCAGCTCCGACTTGTAAATATCAGCCTCGACTATCGAGACTATACAAGGATCTACCTCAGTCGCAATCGAGACTATACAAGGATCTACCTCAGTCGCATATTTATTTATTTATTTGTTTGTTTGTTTTATT
pLLB	GTCAGCTCCGACTTGTAAATATCAGCCTCGACTATCGAGACTATACAAGGATCTACCTCAGTCGCAATCGAGACTATACAAGGATCTACCTCAGTCGCAATCAGCCTCGACTGTGCCTTCTAGTTGCCAGCC
pLLL	GTCAGCTCCGACTTGTAAATATCAGCCTCGACTATCGAGACTATACAAGGATCTACCTCAGTCGCAATCGAGACTATACAAGGATCTACCTCAGTCGCAATCGAGACTATACAAGGATCTACCTCAGTCGCA
pLLS	GTCAGCTCCGACTTGTAAATATCAGCCTCGACTATCGAGACTATACAAGGATCTACCTCAGTCGCAATCGAGACTATACAAGGATCTACCTCAGTCGCACACAAGCAGAGGCTCTGGCAGCTTTTGCCAACA
pLLp	GTCAGCTCCGACTTGTAAATATCAGCCTCGACTATCGAGACTATACAAGGATCTACCTCAGTCGCAATCGAGACTATACAAGGATCTACCTCAGTCGCAGTCAGCTCCGACTTGTAAATATCAGCCTCGACT
pLSA	GTCAGCTCCGACTTGTAAATATCAGCCTCGACTATCGAGACTATACAAGGATCTACCTCAGTCGCACACAAGCAGAGGCTCTGGCAGCTTTTGCCAACATATTTATTTATTTATTTGTTTGTTTGTTTTATT
pLSB	GTCAGCTCCGACTTGTAAATATCAGCCTCGACTATCGAGACTATACAAGGATCTACCTCAGTCGCACACAAGCAGAGGCTCTGGCAGCTTTTGCCAACAATCAGCCTCGACTGTGCCTTCTAGTTGCCAGCC
pLSL	GTCAGCTCCGACTTGTAAATATCAGCCTCGACTATCGAGACTATACAAGGATCTACCTCAGTCGCACACAAGCAGAGGCTCTGGCAGCTTTTGCCAACAATCGAGACTATACAAGGATCTACCTCAGTCGCA
pLSS	GTCAGCTCCGACTTGTAAATATCAGCCTCGACTATCGAGACTATACAAGGATCTACCTCAGTCGCACACAAGCAGAGGCTCTGGCAGCTTTTGCCAACACACAAGCAGAGGCTCTGGCAGCTTTTGCCAACA
pLSp	GTCAGCTCCGACTTGTAAATATCAGCCTCGACTATCGAGACTATACAAGGATCTACCTCAGTCGCACACAAGCAGAGGCTCTGGCAGCTTTTGCCAACAGTCAGCTCCGACTTGTAAATATCAGCCTCGACT
pLpA	GTCAGCTCCGACTTGTAAATATCAGCCTCGACTATCGAGACTATACAAGGATCTACCTCAGTCGCAGTCAGCTCCGACTTGTAAATATCAGCCTCGACTTATTTATTTATTTATTTGTTTGTTTGTTTTATT
pLpB	GTCAGCTCCGACTTGTAAATATCAGCCTCGACTATCGAGACTATACAAGGATCTACCTCAGTCGCAGTCAGCTCCGACTTGTAAATATCAGCCTCGACTATCAGCCTCGACTGTGCCTTCTAGTTGCCAGCC
pLpL	GTCAGCTCCGACTTGTAAATATCAGCCTCGACTATCGAGACTATACAAGGATCTACCTCAGTCGCAGTCAGCTCCGACTTGTAAATATCAGCCTCGACTATCGAGACTATACAAGGATCTACCTCAGTCGCA
pLpS	GTCAGCTCCGACTTGTAAATATCAGCCTCGACTATCGAGACTATACAAGGATCTACCTCAGTCGCAGTCAGCTCCGACTTGTAAATATCAGCCTCGACTCACAAGCAGAGGCTCTGGCAGCTTTTGCCAACA
pLpp	GTCAGCTCCGACTTGTAAATATCAGCCTCGACTATCGAGACTATACAAGGATCTACCTCAGTCGCAGTCAGCTCCGACTTGTAAATATCAGCCTCGACTGTCAGCTCCGACTTGTAAATATCAGCCTCGACT
pSAA	GTCAGCTCCGACTTGTAAATATCAGCCTCGACTCACAAGCAGAGGCTCTGGCAGCTTTTGCCAACATATTTATTTATTTATTTGTTTGTTTGTTTTATTTATTTATTTATTTATTTGTTTGTTTGTTTTATT
pSAB	GTCAGCTCCGACTTGTAAATATCAGCCTCGACTCACAAGCAGAGGCTCTGGCAGCTTTTGCCAACATATTTATTTATTTATTTGTTTGTTTGTTTTATTATCAGCCTCGACTGTGCCTTCTAGTTGCCAGCC
pSAL	GTCAGCTCCGACTTGTAAATATCAGCCTCGACTCACAAGCAGAGGCTCTGGCAGCTTTTGCCAACATATTTATTTATTTATTTGTTTGTTTGTTTTATTATCGAGACTATACAAGGATCTACCTCAGTCGCA
pSAS	GTCAGCTCCGACTTGTAAATATCAGCCTCGACTCACAAGCAGAGGCTCTGGCAGCTTTTGCCAACATATTTATTTATTTATTTGTTTGTTTGTTTTATTCACAAGCAGAGGCTCTGGCAGCTTTTGCCAACA
pSAp	GTCAGCTCCGACTTGTAAATATCAGCCTCGACTCACAAGCAGAGGCTCTGGCAGCTTTTGCCAACATATTTATTTATTTATTTGTTTGTTTGTTTTATTGTCAGCTCCGACTTGTAAATATCAGCCTCGACT
pSBA	GTCAGCTCCGACTTGTAAATATCAGCCTCGACTCACAAGCAGAGGCTCTGGCAGCTTTTGCCAACAATCAGCCTCGACTGTGCCTTCTAGTTGCCAGCCTATTTATTTATTTATTTGTTTGTTTGTTTTATT
pSBB	GTCAGCTCCGACTTGTAAATATCAGCCTCGACTCACAAGCAGAGGCTCTGGCAGCTTTTGCCAACAATCAGCCTCGACTGTGCCTTCTAGTTGCCAGCCATCAGCCTCGACTGTGCCTTCTAGTTGCCAGCC
pSBL	GTCAGCTCCGACTTGTAAATATCAGCCTCGACTCACAAGCAGAGGCTCTGGCAGCTTTTGCCAACAATCAGCCTCGACTGTGCCTTCTAGTTGCCAGCCATCGAGACTATACAAGGATCTACCTCAGTCGCA
pSBS	GTCAGCTCCGACTTGTAAATATCAGCCTCGACTCACAAGCAGAGGCTCTGGCAGCTTTTGCCAACAATCAGCCTCGACTGTGCCTTCTAGTTGCCAGCCCACAAGCAGAGGCTCTGGCAGCTTTTGCCAACA
pSBp	GTCAGCTCCGACTTGTAAATATCAGCCTCGACTCACAAGCAGAGGCTCTGGCAGCTTTTGCCAACAATCAGCCTCGACTGTGCCTTCTAGTTGCCAGCCGTCAGCTCCGACTTGTAAATATCAGCCTCGACT
pSLA	GTCAGCTCCGACTTGTAAATATCAGCCTCGACTCACAAGCAGAGGCTCTGGCAGCTTTTGCCAACAATCGAGACTATACAAGGATCTACCTCAGTCGCATATTTATTTATTTATTTGTTTGTTTGTTTTATT
pSLB	GTCAGCTCCGACTTGTAAATATCAGCCTCGACTCACAAGCAGAGGCTCTGGCAGCTTTTGCCAACAATCGAGACTATACAAGGATCTACCTCAGTCGCAATCAGCCTCGACTGTGCCTTCTAGTTGCCAGCC
pSLL	GTCAGCTCCGACTTGTAAATATCAGCCTCGACTCACAAGCAGAGGCTCTGGCAGCTTTTGCCAACAATCGAGACTATACAAGGATCTACCTCAGTCGCAATCGAGACTATACAAGGATCTACCTCAGTCGCA
pSLS	GTCAGCTCCGACTTGTAAATATCAGCCTCGACTCACAAGCAGAGGCTCTGGCAGCTTTTGCCAACAATCGAGACTATACAAGGATCTACCTCAGTCGCACACAAGCAGAGGCTCTGGCAGCTTTTGCCAACA
pSLp	GTCAGCTCCGACTTGTAAATATCAGCCTCGACTCACAAGCAGAGGCTCTGGCAGCTTTTGCCAACAATCGAGACTATACAAGGATCTACCTCAGTCGCAGTCAGCTCCGACTTGTAAATATCAGCCTCGACT
pSSA	GTCAGCTCCGACTTGTAAATATCAGCCTCGACTCACAAGCAGAGGCTCTGGCAGCTTTTGCCAACACACAAGCAGAGGCTCTGGCAGCTTTTGCCAACATATTTATTTATTTATTTGTTTGTTTGTTTTATT
pSSB	GTCAGCTCCGACTTGTAAATATCAGCCTCGACTCACAAGCAGAGGCTCTGGCAGCTTTTGCCAACACACAAGCAGAGGCTCTGGCAGCTTTTGCCAACAATCAGCCTCGACTGTGCCTTCTAGTTGCCAGCC
pSSL	GTCAGCTCCGACTTGTAAATATCAGCCTCGACTCACAAGCAGAGGCTCTGGCAGCTTTTGCCAACACACAAGCAGAGGCTCTGGCAGCTTTTGCCAACAATCGAGACTATACAAGGATCTACCTCAGTCGCA
pSSS	GTCAGCTCCGACTTGTAAATATCAGCCTCGACTCACAAGCAGAGGCTCTGGCAGCTTTTGCCAACACACAAGCAGAGGCTCTGGCAGCTTTTGCCAACACACAAGCAGAGGCTCTGGCAGCTTTTGCCAACA
pSSp	GTCAGCTCCGACTTGTAAATATCAGCCTCGACTCACAAGCAGAGGCTCTGGCAGCTTTTGCCAACACACAAGCAGAGGCTCTGGCAGCTTTTGCCAACAGTCAGCTCCGACTTGTAAATATCAGCCTCGACT
pSpA	GTCAGCTCCGACTTGTAAATATCAGCCTCGACTCACAAGCAGAGGCTCTGGCAGCTTTTGCCAACAGTCAGCTCCGACTTGTAAATATCAGCCTCGACTTATTTATTTATTTATTTGTTTGTTTGTTTTATT
pSpB	GTCAGCTCCGACTTGTAAATATCAGCCTCGACTCACAAGCAGAGGCTCTGGCAGCTTTTGCCAACAGTCAGCTCCGACTTGTAAATATCAGCCTCGACTATCAGCCTCGACTGTGCCTTCTAGTTGCCAGCC
pSpL	GTCAGCTCCGACTTGTAAATATCAGCCTCGACTCACAAGCAGAGGCTCTGGCAGCTTTTGCCAACAGTCAGCTCCGACTTGTAAATATCAGCCTCGACTATCGAGACTATACAAGGATCTACCTCAGTCGCA
pSpS	GTCAGCTCCGACTTGTAAATATCAGCCTCGACTCACAAGCAGAGGCTCTGGCAGCTTTTGCCAACAGTCAGCTCCGACTTGTAAATATCAGCCTCGACTCACAAGCAGAGGCTCTGGCAGCTTTTGCCAACA
pSpp	GTCAGCTCCGACTTGTAAATATCAGCCTCGACTCACAAGCAGAGGCTCTGGCAGCTTTTGCCAACAGTCAGCTCCGACTTGTAAATATCAGCCTCGACTGTCAGCTCCGACTTGTAAATATCAGCCTCGACT
ppAA	GTCAGCTCCGACTTGTAAATATCAGCCTCGACTGTCAGCTCCGACTTGTAAATATCAGCCTCGACTTATTTATTTATTTATTTGTTTGTTTGTTTTATTTATTTATTTATTTATTTGTTTGTTTGTTTTATT
ppAB	GTCAGCTCCGACTTGTAAATATCAGCCTCGACTGTCAGCTCCGACTTGTAAATATCAGCCTCGACTTATTTATTTATTTATTTGTTTGTTTGTTTTATTATCAGCCTCGACTGTGCCTTCTAGTTGCCAGCC
ppAL	GTCAGCTCCGACTTGTAAATATCAGCCTCGACTGTCAGCTCCGACTTGTAAATATCAGCCTCGACTTATTTATTTATTTATTTGTTTGTTTGTTTTATTATCGAGACTATACAAGGATCTACCTCAGTCGCA
ppAS	GTCAGCTCCGACTTGTAAATATCAGCCTCGACTGTCAGCTCCGACTTGTAAATATCAGCCTCGACTTATTTATTTATTTATTTGTTTGTTTGTTTTATTCACAAGCAGAGGCTCTGGCAGCTTTTGCCAACA
ppAp	GTCAGCTCCGACTTGTAAATATCAGCCTCGACTGTCAGCTCCGACTTGTAAATATCAGCCTCGACTTATTTATTTATTTATTTGTTTGTTTGTTTTATTGTCAGCTCCGACTTGTAAATATCAGCCTCGACT
ppBA	GTCAGCTCCGACTTGTAAATATCAGCCTCGACTGTCAGCTCCGACTTGTAAATATCAGCCTCGACTATCAGCCTCGACTGTGCCTTCTAGTTGCCAGCCTATTTATTTATTTATTTGTTTGTTTGTTTTATT
ppBB	GTCAGCTCCGACTTGTAAATATCAGCCTCGACTGTCAGCTCCGACTTGTAAATATCAGCCTCGACTATCAGCCTCGACTGTGCCTTCTAGTTGCCAGCCATCAGCCTCGACTGTGCCTTCTAGTTGCCAGCC
ppBL	GTCAGCTCCGACTTGTAAATATCAGCCTCGACTGTCAGCTCCGACTTGTAAATATCAGCCTCGACTATCAGCCTCGACTGTGCCTTCTAGTTGCCAGCCATCGAGACTATACAAGGATCTACCTCAGTCGCA
ppBS	GTCAGCTCCGACTTGTAAATATCAGCCTCGACTGTCAGCTCCGACTTGTAAATATCAGCCTCGACTATCAGCCTCGACTGTGCCTTCTAGTTGCCAGCCCACAAGCAGAGGCTCTGGCAGCTTTTGCCAACA
ppBp	GTCAGCTCCGACTTGTAAATATCAGCCTCGACTGTCAGCTCCGACTTGTAAATATCAGCCTCGACTATCAGCCTCGACTGTGCCTTCTAGTTGCCAGCCGTCAGCTCCGACTTGTAAATATCAGCCTCGACT
ppLA	GTCAGCTCCGACTTGTAAATATCAGCCTCGACTGTCAGCTCCGACTTGTAAATATCAGCCTCGACTATCGAGACTATACAAGGATCTACCTCAGTCGCATATTTATTTATTTATTTGTTTGTTTGTTTTATT
ppLB	GTCAGCTCCGACTTGTAAATATCAGCCTCGACTGTCAGCTCCGACTTGTAAATATCAGCCTCGACTATCGAGACTATACAAGGATCTACCTCAGTCGCAATCAGCCTCGACTGTGCCTTCTAGTTGCCAGCC
ppLL	GTCAGCTCCGACTTGTAAATATCAGCCTCGACTGTCAGCTCCGACTTGTAAATATCAGCCTCGACTATCGAGACTATACAAGGATCTACCTCAGTCGCAATCGAGACTATACAAGGATCTACCTCAGTCGCA
ppLS	GTCAGCTCCGACTTGTAAATATCAGCCTCGACTGTCAGCTCCGACTTGTAAATATCAGCCTCGACTATCGAGACTATACAAGGATCTACCTCAGTCGCACACAAGCAGAGGCTCTGGCAGCTTTTGCCAACA
ppLp	GTCAGCTCCGACTTGTAAATATCAGCCTCGACTGTCAGCTCCGACTTGTAAATATCAGCCTCGACTATCGAGACTATACAAGGATCTACCTCAGTCGCAGTCAGCTCCGACTTGTAAATATCAGCCTCGACT
ppSA	GTCAGCTCCGACTTGTAAATATCAGCCTCGACTGTCAGCTCCGACTTGTAAATATCAGCCTCGACTCACAAGCAGAGGCTCTGGCAGCTTTTGCCAACATATTTATTTATTTATTTGTTTGTTTGTTTTATT
ppSB	GTCAGCTCCGACTTGTAAATATCAGCCTCGACTGTCAGCTCCGACTTGTAAATATCAGCCTCGACTCACAAGCAGAGGCTCTGGCAGCTTTTGCCAACAATCAGCCTCGACTGTGCCTTCTAGTTGCCAGCC
ppSL	GTCAGCTCCGACTTGTAAATATCAGCCTCGACTGTCAGCTCCGACTTGTAAATATCAGCCTCGACTCACAAGCAGAGGCTCTGGCAGCTTTTGCCAACAATCGAGACTATACAAGGATCTACCTCAGTCGCA
ppSS	GTCAGCTCCGACTTGTAAATATCAGCCTCGACTGTCAGCTCCGACTTGTAAATATCAGCCTCGACTCACAAGCAGAGGCTCTGGCAGCTTTTGCCAACACACAAGCAGAGGCTCTGGCAGCTTTTGCCAACA
ppSp	GTCAGCTCCGACTTGTAAATATCAGCCTCGACTGTCAGCTCCGACTTGTAAATATCAGCCTCGACTCACAAGCAGAGGCTCTGGCAGCTTTTGCCAACAGTCAGCTCCGACTTGTAAATATCAGCCTCGACT
pppA	GTCAGCTCCGACTTGTAAATATCAGCCTCGACTGTCAGCTCCGACTTGTAAATATCAGCCTCGACTGTCAGCTCCGACTTGTAAATATCAGCCTCGACTTATTTATTTATTTATTTGTTTGTTTGTTTTATT
pppB	GTCAGCTCCGACTTGTAAATATCAGCCTCGACTGTCAGCTCCGACTTGTAAATATCAGCCTCGACTGTCAGCTCCGACTTGTAAATATCAGCCTCGACTATCAGCCTCGACTGTGCCTTCTAGTTGCCAGCC
pppL	GTCAGCTCCGACTTGTAAATATCAGCCTCGACTGTCAGCTCCGACTTGTAAATATCAGCCTCGACTGTCAGCTCCGACTTGTAAATATCAGCCTCGACTATCGAGACTATACAAGGATCTACCTCAGTCGCA
pppS	GTCAGCTCCGACTTGTAAATATCAGCCTCGACTGTCAGCTCCGACTTGTAAATATCAGCCTCGACTGTCAGCTCCGACTTGTAAATATCAGCCTCGACTCACAAGCAGAGGCTCTGGCAGCTTTTGCCAACA
pppp	GTCAGCTCCGACTTGTAAATATCAGCCTCGACTGTCAGCTCCGACTTGTAAATATCAGCCTCGACTGTCAGCTCCGACTTGTAAATATCAGCCTCGACTGTCAGCTCCGACTTGTAAATATCAGCCTCGACT
